"wk","strat","Nj","yE","yC","yO","yES","yEM","yCS","yCM","yOS","yOM","yS","yM","kS","kM","zES","zCS","zOS","zEM","zCM","zOM","temp","logtheta.E","logtheta.C","logtheta.O"
1,1,90000,1065,768,577,322,743,23,745,13,564,358,2052,161,21,145,13,3,7,5,9,6.48045112781955,-0.480342803330587,-0.226895109667657,-0.171387774253721
2,1,90000,997,812,559,304,693,22,790,9,550,335,2033,151,20,135,11,5,5,10,5,5.33646616541353,-0.457465616493521,-0.213161479985628,-0.171345676755081
3,1,90000,998,794,554,290,708,22,772,8,546,320,2026,144,20,131,10,3,7,8,5,1.64360902255639,-0.433060237991038,-0.198032261641117,-0.175221152576721
4,1,90000,1124,798,555,327,797,27,771,8,547,362,2115,163,21,145,13,5,6,6,9,8.12481203007519,-0.364066696752449,-0.163389680839,-0.15149115426656
5,1,90000,1132,802,598,343,789,21,781,9,589,373,2159,168,22,150,13,5,8,10,4,4.10263157894737,-0.324752531030578,-0.141413687448797,-0.152230811473241
6,1,90000,1329,857,587,377,952,36,821,8,579,421,2352,189,24,170,16,3,11,8,5,10.1199248120301,-0.245442361045558,-0.102587858262687,-0.126540524924286
7,1,90000,1376,910,633,426,950,21,889,9,624,456,2463,205,25,193,10,2,12,7,6,18.9462406015038,-0.153879721944638,-0.0591196420139427,-0.0930047877039546
8,1,90000,1416,928,592,416,1000,30,898,10,582,456,2480,205,25,185,16,4,10,11,4,8.0411320754717,-0.131478420441954,-0.0461721088572488,-0.108506149944481
9,1,90000,1520,913,618,446,1074,25,888,9,609,480,2571,216,26,204,9,3,10,9,7,7.85827067669173,-0.0741269575935405,-0.0193355289724893,-0.0974362028061945
10,1,90000,1630,954,634,515,1115,36,918,6,628,557,2661,251,27,232,16,3,15,9,3,18.8507518796992,0.0174579989639795,0.0209477267391996,-0.0591542334277128
11,1,90000,1756,947,668,538,1218,18,929,12,656,568,2803,256,28,243,8,5,9,12,7,24.1338345864662,0.0821687853396189,0.0484355488049923,-0.0363045306879426
12,1,90000,1822,1012,668,547,1275,36,976,16,652,599,2903,270,29,247,18,5,12,12,5,28.706015037594,0.135881154725879,0.0699638036336846,-0.0167415416974004
13,1,90000,1850,985,685,541,1309,36,949,7,678,584,2936,263,29,246,15,2,15,7,7,25.0221804511278,0.151038466134901,0.0738374590298947,-0.0195797520494748
14,1,90000,1969,983,666,576,1393,31,952,4,662,611,3007,275,30,255,18,2,13,13,4,30.4131578947368,0.187671471392127,0.0859748836434954,-0.00163345059642431
15,1,90000,2011,1067,747,595,1416,25,1042,12,735,632,3193,284,32,258,17,9,14,11,7,47.6575187969925,0.25542146815919,0.110763346313488,0.0440176633099953
16,1,90000,2041,1019,680,615,1426,33,986,13,667,661,3079,297,31,270,19,8,16,12,3,45.1555555555556,0.244140475559308,0.10130081368763,0.038461587280371
17,1,90000,1990,1024,739,591,1399,34,990,15,724,640,3113,288,31,260,19,9,16,8,7,45.3868421052632,0.233454073042172,0.0920473616784966,0.0380895214983732
18,1,90000,2114,1025,761,621,1493,35,990,14,747,670,3230,302,32,281,15,6,18,12,2,51.9751879699248,0.237422642010662,0.0893740165672838,0.0522438282961684
19,1,90000,2115,1049,711,616,1499,36,1013,12,699,664,3211,299,32,277,16,6,15,10,7,63.1586466165414,0.25159679518469,0.0917083999837295,0.0768734766368026
20,1,90000,2057,974,714,623,1434,21,953,9,705,653,3092,294,31,279,11,4,15,10,6,57.4799196787149,0.202825996149261,0.0680036873880545,0.0587364999118144
21,1,90000,1980,985,757,580,1400,24,961,14,743,618,3104,278,31,264,9,5,17,8,6,62.6281954887218,0.190085337795467,0.0609313467944231,0.0674784649438717
22,1,90000,1971,968,744,599,1372,27,941,15,729,641,3042,288,30,265,13,10,14,11,5,67.7966165413534,0.177602155727874,0.0553480444843275,0.0764989864857269
23,1,90000,1824,1036,683,573,1251,32,1004,12,671,617,2926,278,29,260,15,3,15,8,6,63.0624060150376,0.132564333491691,0.0373013068030377,0.0613754664794903
24,1,90000,1832,964,689,580,1252,31,933,14,675,625,2860,281,29,263,11,7,8,10,11,62.5830827067669,0.106194391677067,0.0287678414917604,0.057829198714364
25,1,90000,1718,989,718,502,1216,29,960,8,710,539,2886,243,29,223,16,4,15,12,2,62.3285714285714,0.0857152038361886,0.0242074870012309,0.0560347962886817
26,1,90000,1822,954,791,510,1312,38,916,13,778,561,3006,252,30,223,23,6,9,8,13,67.5,0.0902406797170965,0.0316615447876121,0.0691511486768509
27,1,90000,1775,953,753,504,1271,20,933,7,746,531,2950,239,30,226,11,2,13,9,8,69.7206766917293,0.0908949482863478,0.0385254659229134,0.0762885900205207
28,1,90000,1741,962,757,496,1245,33,929,6,751,535,2925,241,29,222,14,5,15,8,6,71.55,0.0965904610702635,0.0483228128555467,0.0837897684841498
29,1,90000,1749,1014,738,500,1249,27,987,9,729,536,2965,241,30,223,15,3,13,11,6,70.9537593984962,0.0996832351121792,0.0574304941269727,0.0864081012001773
30,1,90000,1834,1071,724,539,1295,36,1035,7,717,582,3047,262,30,240,20,2,9,14,7,70.168045112782,0.107034874713776,0.0684099368863603,0.0894767117085245
31,1,90000,1824,1001,720,559,1265,24,977,7,713,590,2955,266,30,255,8,3,12,11,7,72.2263157894737,0.127922468290149,0.0848464534645842,0.100241196170811
32,1,90000,1822,1033,786,569,1253,32,1001,5,781,606,3035,273,30,258,13,2,13,10,7,74.7161654135338,0.152275365142446,0.102043761656887,0.112271698401175
33,1,90000,1896,1078,746,544,1352,26,1052,7,739,577,3143,260,31,250,6,4,16,10,5,76.5744360902256,0.174563866092158,0.117283155773224,0.122474739807178
34,1,90000,1882,1104,770,599,1283,29,1075,9,761,637,3119,287,31,265,16,6,14,13,4,73.5515037593985,0.17804145752043,0.123089676418286,0.119780471877388
35,1,90000,1973,1066,783,604,1369,39,1027,12,771,655,3167,295,32,273,16,6,11,11,10,67.9676691729323,0.16901391397769,0.121935590092754,0.109561133244395
36,1,90000,1878,993,768,589,1289,30,963,12,756,631,3008,284,30,268,10,6,10,15,5,63.8785714285714,0.160037271215473,0.119052508725647,0.101571396453071
37,1,90000,1892,1068,740,571,1321,34,1034,10,730,615,3085,277,31,255,19,3,11,11,9,61.496992481203,0.15050339762478,0.114119431565313,0.0960274510270936
38,1,90000,1901,1042,755,580,1321,32,1010,10,745,622,3076,280,31,261,17,2,8,18,5,62.0642857142857,0.143782975086623,0.108613282748086,0.0958064558046156
39,1,90000,1760,1011,753,524,1236,29,982,10,743,563,2961,253,30,234,14,5,11,17,2,55.5759398496241,0.104336108186444,0.0874261189678943,0.0757763976890443
40,1,90000,1753,1029,722,518,1235,35,994,14,708,567,2937,255,29,231,15,9,13,9,7,56.6639097744361,0.0833454598722529,0.0727011965322283,0.0725119754031822
41,1,90000,1607,1023,748,482,1125,39,984,9,739,530,2848,238,28,221,14,3,12,10,6,49.9646616541353,0.0275204263602648,0.041880497784093,0.0477182528919765
42,1,90000,1594,996,695,469,1125,27,969,8,687,504,2781,227,28,214,9,4,8,13,7,49.2778195488722,-0.013861672532927,0.0164212123258671,0.0361240497817079
43,1,90000,1561,950,643,481,1080,28,922,16,627,525,2629,236,26,217,10,9,13,8,5,43.3552631578947,-0.0787373011442823,-0.0195579103055757,0.00994483056105516
44,1,90000,1509,929,643,469,1040,35,894,6,637,510,2571,230,26,214,13,3,8,10,8,44.4067669172932,-0.122557675750492,-0.0465691457383104,0.000130836669410328
45,1,90000,1261,804,660,381,880,25,779,6,654,412,2313,185,23,168,15,2,8,10,5,28.8853383458647,-0.225634039041668,-0.0986397291389445,-0.0516907732839852
46,1,90000,1261,837,645,403,858,37,800,13,632,453,2290,204,23,184,16,4,10,7,6,31.2541353383459,-0.26506540526894,-0.122730834332872,-0.0588239029774236
47,1,90000,1084,807,598,337,747,24,783,8,590,369,2120,166,21,151,11,4,6,9,6,15.2642857142857,-0.365389831497141,-0.171893693855068,-0.111336900667728
48,1,90000,1092,786,599,327,765,35,751,9,590,371,2106,167,21,151,10,6,5,10,6,16.1868421052632,-0.400900891760629,-0.191993882102507,-0.120511697823835
49,1,90000,1025,765,551,323,702,14,751,11,540,348,1993,157,20,151,2,4,7,10,3,11.1744360902256,-0.449507580393211,-0.216236314861189,-0.142968164714038
50,1,90000,1038,739,575,299,739,29,710,7,568,335,2017,151,20,136,14,1,4,8,8,8.9890977443609,-0.478802839249891,-0.23063242769153,-0.156370915300531
51,1,90000,961,691,538,260,701,17,674,7,531,284,1906,128,19,112,11,5,5,7,7,6.42781954887218,-0.498673547200389,-0.239408809356805,-0.168388130906705
52,1,90000,955,745,587,317,638,17,728,6,581,340,1947,153,19,148,2,3,7,7,5,5.06503759398496,-0.502779151160257,-0.239925851012466,-0.174853191115061
53,1,90000,937,759,576,281,656,31,728,10,566,322,1950,145,20,125,15,5,10,6,4,-3.20413533834586,-0.519201050830736,-0.244378808815996,-0.195918523384973
54,1,90000,989,785,547,276,713,18,767,6,541,300,2021,135,20,120,9,6,7,5,8,-4.30263157894737,-0.498949250110498,-0.232004425403326,-0.196407770757025
55,1,90000,1011,754,591,319,692,21,733,11,580,351,2005,158,20,143,11,4,6,10,4,-1.52406015037594,-0.454386833659465,-0.208391116250526,-0.184695869953394
56,1,90000,1073,772,574,336,737,22,750,9,565,367,2052,165,21,152,9,4,5,6,10,4.27669172932331,-0.389856947478884,-0.175729869135232,-0.16317728476021
57,1,90000,1129,808,571,368,761,24,784,9,562,401,2107,180,21,163,12,5,11,4,6,8.05263157894737,-0.324822372914429,-0.142711221861423,-0.144828512160552
58,1,90000,1224,803,567,381,843,22,781,11,556,414,2180,186,22,170,9,7,13,6,3,2.24398496240602,-0.287895174622372,-0.121945546163073,-0.148989756030231
59,1,90000,1308,871,589,427,881,23,848,11,578,461,2307,207,23,192,9,6,9,12,2,7.52857142857143,-0.209098446032012,-0.083768726274379,-0.124464655714525
60,1,90000,1381,875,557,394,987,31,844,8,549,433,2380,195,24,175,17,3,8,6,10,3.35037593984962,-0.162891422818092,-0.0603764124501685,-0.123171597937717
61,1,90000,1508,892,586,458,1050,21,871,12,574,491,2495,221,25,201,14,6,9,10,6,14.6725563909774,-0.0644031234212173,-0.0156216125295365,-0.0832325592301521
62,1,90000,1615,971,637,466,1149,22,949,6,631,494,2729,222,27,208,12,2,14,6,7,11.4473684210526,-0.0211581638761946,0.00425898319774624,-0.0802698987943983
63,1,90000,1688,979,626,469,1219,26,953,12,614,507,2786,228,28,210,10,8,8,16,4,12.9695488721805,0.0322809051349889,0.02723588157102,-0.0664963525444209
64,1,90000,1746,1042,658,528,1218,18,1024,17,641,563,2883,253,29,240,8,5,10,15,4,20.5977443609023,0.098944051700547,0.0546183405717465,-0.0388882555576356
65,1,90000,1904,1050,665,550,1354,26,1024,13,652,589,3030,265,30,246,10,9,13,4,13,25.8639097744361,0.147920891062787,0.0732537348156142,-0.0188934781384163
66,1,90000,1921,988,667,591,1330,31,957,11,656,633,2943,285,29,268,12,5,13,9,7,28.6398496240602,0.178001963213569,0.0827965582419269,-0.00700217009799764
67,1,90000,2028,1035,717,594,1434,34,1001,13,704,641,3139,288,31,265,20,3,12,16,3,34.8736842105263,0.209785750288062,0.092315229661502,0.0116009435031792
68,1,90000,1916,1009,666,574,1342,26,983,11,655,611,2980,275,30,254,12,9,13,11,6,34.2984962406015,0.207657845014576,0.086840060335501,0.0113080244612906
69,1,90000,1971,936,657,579,1392,21,915,8,649,608,2956,274,30,261,11,2,19,6,5,40.4736842105263,0.219904374012812,0.0873941317551019,0.0261847140422411
70,1,90000,2111,1024,717,656,1455,30,994,8,709,694,3158,312,32,293,14,5,17,9,6,47.1097744360902,0.225789296439384,0.0854350965601265,0.0407691753611072
71,1,90000,1968,1017,718,603,1365,21,996,13,705,637,3066,287,31,270,10,7,13,11,7,53.7281954887218,0.225279440108727,0.0812878599344371,0.054203141170761
72,1,90000,2020,1033,711,593,1427,32,1001,8,703,633,3131,285,31,269,12,4,16,10,5,49.9665413533835,0.184009116567657,0.0605372924486023,0.0409723892406703
73,1,90000,1913,984,818,568,1345,19,965,18,800,605,3110,272,31,254,10,8,12,10,9,61.0992481203008,0.192485161733066,0.0622396881840867,0.0646828095144771
74,1,90000,1950,994,774,597,1353,35,959,10,764,642,3076,289,31,268,17,4,15,9,7,66.8770676691729,0.181901110716571,0.0571121137107011,0.0751320411115415
75,1,90000,1890,1030,738,602,1288,25,1005,12,726,639,3019,288,30,276,9,3,10,15,5,66.1199248120301,0.15008878584478,0.044355606500437,0.0697647439116168
76,1,90000,1883,989,694,562,1321,27,962,13,681,602,2964,271,30,250,13,8,11,12,7,73.7360902255639,0.150969729996724,0.0471254730316501,0.0861954206568286
77,1,90000,1848,931,730,556,1292,26,905,9,721,591,2918,266,29,249,14,3,13,12,4,73.1015037593985,0.127781604248876,0.0410528406854354,0.0831348558791788
78,1,90000,1802,982,683,563,1239,21,961,13,670,597,2870,269,29,253,8,8,15,7,7,71.3887218045113,0.106648548504006,0.037204430267177,0.0786951447584057
79,1,90000,1854,934,747,576,1278,29,905,8,739,613,2922,276,29,259,15,2,14,7,8,78.9342105263158,0.124310678632372,0.0511155832130839,0.0987961397405023
80,1,90000,1751,990,716,496,1255,33,957,14,702,543,2914,244,29,221,16,7,16,8,5,72.3451127819549,0.0989698538107144,0.0474492690742945,0.0849268329392336
81,1,90000,1843,968,682,545,1298,34,934,12,670,591,2902,266,29,247,13,6,9,8,12,71.9466165413534,0.101357203993689,0.0561828218283034,0.0877648270015677
82,1,90000,1816,1018,782,540,1276,26,992,20,762,586,3030,264,30,247,12,5,13,9,8,74.7236842105263,0.120060386362028,0.072052120751766,0.0995382413376656
83,1,90000,1938,1039,722,562,1376,32,1007,12,710,606,3093,273,31,255,14,4,15,12,4,74.587969924812,0.132516556985215,0.0849976063578373,0.104706687903808
84,1,90000,1907,1031,750,528,1379,30,1001,14,736,572,3116,257,31,243,10,4,13,13,5,72.0605263157895,0.13898464649705,0.0947453637798042,0.104187029840973
85,1,90000,1793,1061,739,563,1230,41,1020,12,727,616,2977,277,30,259,13,5,8,13,9,70.1992481203008,0.148393335500009,0.104763359309366,0.105195189500474
86,1,90000,1927,1052,760,575,1352,34,1018,15,745,624,3115,281,31,256,18,7,17,7,7,72.0759398496241,0.169625796718523,0.118546352861772,0.114964874133463
87,1,90000,1892,1047,760,571,1321,28,1019,11,749,610,3089,274,31,254,13,7,17,9,5,70.1428571428571,0.174423871231455,0.123735200145799,0.114191323562926
88,1,90000,1951,1057,741,606,1345,35,1022,15,726,656,3093,295,31,268,20,7,14,8,9,69.9116541353384,0.180384761968242,0.127700864545134,0.116255808719474
89,1,90000,1897,1132,781,608,1289,32,1100,14,767,654,3156,294,32,267,19,8,16,8,8,66.8759398496241,0.170302317578607,0.122986082807785,0.109557296985801
90,1,90000,1940,1046,813,551,1389,25,1021,13,800,589,3210,265,32,248,9,8,13,10,9,70.0962406015038,0.174812015153839,0.12272946113827,0.116496787677807
91,1,90000,1806,1068,718,577,1229,34,1034,8,710,619,2973,279,30,256,19,4,13,8,9,54.4342105263158,0.105287752276487,0.089049485581416,0.0740801224097095
92,1,90000,1705,993,731,513,1192,25,968,8,723,546,2883,246,29,229,14,3,15,6,8,51.2857142857143,0.0714594789635244,0.0691609044845597,0.0607622940294937
93,1,90000,1714,1030,728,491,1223,28,1002,14,714,533,2939,240,29,222,13,5,15,9,5,51.0481203007519,0.0400721543465562,0.0490754284889244,0.052620887840081
94,1,90000,1655,1034,715,491,1164,31,1003,9,706,531,2873,239,29,217,18,4,18,5,6,52.0718045112782,0.00620947027644758,0.0270116647613235,0.0457333089055447
95,1,90000,1458,930,701,424,1034,33,897,11,690,468,2621,211,26,189,16,6,15,6,5,37.340977443609,-0.0883595869753003,-0.0216171436738001,-0.00212938225589102
96,1,90000,1393,845,665,427,966,25,820,5,660,457,2446,206,24,196,7,3,9,9,6,36.8800751879699,-0.136822591397133,-0.0506413764636263,-0.0155009988253975
97,1,90000,1339,855,654,394,945,29,826,10,644,433,2415,195,24,180,10,5,10,10,4,35.8428571428571,-0.189100424755843,-0.0810609118087754,-0.0310174781397493
98,1,90000,1244,807,672,394,850,23,784,13,659,430,2293,194,23,179,8,7,9,6,8,33.6657894736842,-0.244918447290251,-0.112382907175698,-0.0495578031083817
99,1,90000,1136,818,596,347,789,30,788,15,581,392,2158,176,22,155,12,9,8,13,1,25.5466165413534,-0.318752852839341,-0.150476300789734,-0.0825749822048115
100,1,90000,1175,794,593,352,823,18,776,6,587,376,2186,169,22,157,9,3,7,8,7,30.4191729323308,-0.342046653911926,-0.165682357149812,-0.0821879233581078
101,1,90000,1104,739,579,336,768,24,715,7,572,367,2055,165,21,157,7,1,8,8,5,13.2315789473684,-0.435363030794457,-0.209466412235264,-0.135514722764687
102,1,90000,1027,726,618,331,696,22,704,13,605,366,2005,165,20,153,9,3,9,6,5,10.8842105263158,-0.467721431673592,-0.225572306560017,-0.149854773351653
103,1,90000,995,688,556,295,700,19,669,10,546,324,1915,146,19,133,9,4,4,10,5,-0.17406015037594,-0.520114879678405,-0.248678266257015,-0.183721931046173
104,1,90000,1001,694,576,300,701,22,672,7,569,329,1942,148,19,138,6,4,4,8,7,6.75977443609023,-0.498123560809172,-0.238374675589769,-0.17009958170428
105,1,90000,1018,765,557,301,717,22,743,12,545,335,2005,151,20,136,11,4,9,5,6,1.50300751879699,-0.506961991857181,-0.239894001947286,-0.184303749348904
106,1,90000,994,779,567,307,687,30,749,4,563,341,1999,153,20,140,12,1,4,8,8,4.17992277992278,-0.476333260682286,-0.223324652949313,-0.176008382469324
107,1,90000,1021,720,577,295,726,13,707,9,568,317,2001,143,20,132,6,5,9,7,4,-2.0109022556391,-0.46574147000596,-0.214445523948104,-0.18732731712926
108,1,90000,1021,759,586,296,725,15,744,8,578,319,2047,144,20,133,8,3,7,7,6,-4.19436090225564,-0.431351247094767,-0.194791551449935,-0.186302080519123
109,1,90000,1195,815,574,359,836,36,779,7,567,402,2182,181,22,158,18,5,8,11,3,-1.0484962406015,-0.370230051912914,-0.163452301154652,-0.169963034524247
110,1,90000,1263,846,597,389,874,23,823,10,587,422,2284,190,23,172,14,4,7,9,7,2.72593984962406,-0.300904577057778,-0.128718142029149,-0.150484523289981
111,1,90000,1336,867,625,427,909,28,839,7,618,462,2366,208,24,192,13,3,13,7,4,12.0545112781955,-0.208481476493809,-0.0845396074091118,-0.116038936872732
112,1,90000,1369,830,613,414,955,22,808,6,607,442,2370,199,24,187,10,2,13,6,5,5.99924812030075,-0.16873955523964,-0.0636899314040038,-0.119494667484491
113,1,90000,1558,942,637,456,1102,28,914,6,631,490,2647,220,26,209,9,2,12,5,9,22.6936090225564,-0.0507273729179657,-0.0102893197567163,-0.0660502586898332
114,1,90000,1589,952,586,466,1123,38,914,9,577,513,2614,231,26,211,15,5,7,8,11,13.2339768339768,-0.0280125248416427,0.00110248547195953,-0.0784770575874576
115,1,90000,1725,964,686,498,1227,33,931,11,675,542,2833,244,28,221,17,6,9,8,11,20.8541353383459,0.0485526626521085,0.034311062663182,-0.0491558678580003
116,1,90000,1838,1002,656,546,1292,26,976,9,647,581,2915,261,29,248,9,4,12,10,7,25.6233082706767,0.107384153531798,0.0586469152320032,-0.0283076801562743
117,1,90000,1947,1025,695,589,1358,22,1003,11,684,622,3045,280,30,260,14,6,18,8,4,28.8710526315789,0.151743354231042,0.0755818306426246,-0.0129116035566219
118,1,90000,2006,1019,707,634,1372,30,989,10,697,674,3058,303,31,284,18,1,14,7,10,34.8748120300752,0.195708752607854,0.0913035523673018,0.00752841560597346
119,1,90000,2060,1053,666,627,1433,23,1030,13,653,663,3116,298,31,286,7,5,14,10,7,43.1200772200772,0.23712332109574,0.105112439195794,0.0316421705823632
120,1,90000,2053,1045,670,575,1478,31,1014,10,660,616,3152,277,32,256,15,6,15,10,7,44.9804511278195,0.245981313830555,0.104430785574008,0.03789488553926
121,1,90000,2003,1022,720,599,1404,34,988,11,709,644,3101,290,31,268,17,5,15,9,7,45.4996240601504,0.240641300799285,0.0974485275818272,0.0390369952988153
122,1,90000,2050,1076,673,596,1454,37,1039,10,663,643,3156,289,32,264,22,3,15,7,10,43.8932330827068,0.219529912265891,0.0838339573488465,0.0333472939408884
123,1,90000,1894,1027,701,553,1341,34,993,5,696,592,3030,266,30,250,13,3,9,13,8,51.9751879699248,0.225555544549135,0.0823188300647106,0.0506816189442638
124,1,90000,1998,1054,702,602,1396,27,1027,14,688,643,3111,289,31,265,15,9,13,13,5,55.5124060150376,0.210750498735729,0.0726669905115167,0.0558379608368557
125,1,90000,1963,978,755,630,1333,23,955,12,743,665,3031,299,30,282,11,6,13,11,6,56.0902255639098,0.182685360013453,0.0584036541689275,0.0531949706114979
126,1,90000,1922,975,746,575,1347,24,951,9,737,608,3035,274,30,260,12,2,12,11,7,59.4473684210526,0.163518376369671,0.0492476792973801,0.0575225258502303
127,1,90000,1854,942,724,534,1320,27,915,11,713,572,2948,257,29,234,14,9,15,8,6,65.1364661654135,0.153683064429101,0.0455349516252291,0.0681059805332208
128,1,90000,1761,958,731,557,1204,32,926,7,724,596,2854,268,29,245,18,5,13,9,7,64.7462406015038,0.125547580870169,0.0354909471121359,0.0642759213001713
129,1,90000,1874,968,710,577,1297,35,933,9,701,621,2931,279,29,255,18,6,13,11,5,66.1951127819549,0.108336923310662,0.0316206686836005,0.0661193807725729
130,1,90000,1887,1008,750,563,1324,27,981,8,742,598,3047,269,30,253,13,3,11,17,2,73.1890977443609,0.116149049571364,0.0398581769801373,0.0831059949327446
131,1,90000,1793,1008,705,547,1246,32,976,8,697,587,2919,264,29,248,13,3,6,16,7,69.8081081081081,0.0939443199901961,0.0364240649307934,0.0755405083592197
132,1,90000,1810,1017,755,524,1286,31,986,10,745,565,3017,254,30,234,16,4,15,10,5,74.3928571428571,0.106114502130802,0.0486504330400319,0.0892728881111784
133,1,90000,1808,986,751,549,1259,39,947,12,739,600,2945,270,29,243,21,6,18,8,3,72.6210526315789,0.102243723097466,0.054606705979947,0.088388201707456
134,1,90000,1846,996,769,574,1272,34,962,8,761,616,2995,277,30,265,7,5,14,9,7,75.9139097744361,0.121555214971358,0.0707371517113703,0.10122887501117
135,1,90000,1855,1007,806,572,1283,31,976,15,791,618,3050,278,30,257,16,5,14,10,6,76.3864661654135,0.135289558703969,0.0843287012472442,0.107782698102081
136,1,90000,1852,1066,730,506,1346,35,1031,7,723,548,3100,247,31,230,13,4,11,12,8,74.1616541353384,0.142381139829297,0.0945365243195326,0.107985762658338
137,1,90000,1871,1025,796,587,1284,29,996,10,786,626,3066,282,31,265,11,6,12,10,9,76.5913533834587,0.166829503209969,0.111279009612295,0.119797358811742
138,1,90000,1912,1008,652,571,1341,31,977,9,643,611,2961,275,30,261,8,6,16,7,7,71.8639097744361,0.165438018071676,0.115717668725104,0.11324425155583
139,1,90000,1847,1049,721,578,1269,38,1011,8,713,624,2993,281,30,262,16,3,7,11,12,68.6078947368421,0.166547413904644,0.119732606349226,0.109457287622695
140,1,90000,1972,1127,762,620,1352,31,1096,9,753,660,3201,297,32,280,13,4,14,11,7,71.9571428571429,0.186384693667725,0.130087016709206,0.120861336837477
141,1,90000,1991,1062,777,584,1407,34,1028,10,767,628,3202,283,32,258,19,6,11,15,6,63.2962406015038,0.158287342198731,0.118105529071832,0.100564897372325
142,1,90000,1863,1035,753,586,1277,27,1008,16,737,629,3022,283,30,262,14,7,14,11,5,62.503007518797,0.150653891700526,0.113087665307321,0.0979891951256875
143,1,90000,1805,993,681,527,1278,27,966,11,670,565,2914,254,29,235,15,4,16,10,3,54.087969924812,0.108514762334367,0.0915534535882425,0.0742354219796413
144,1,90000,1763,1067,699,546,1217,36,1031,9,690,591,2938,266,29,242,19,5,9,12,8,58.3789473684211,0.102736821145172,0.0840411873905038,0.08005930490172
145,1,90000,1765,976,745,518,1247,29,947,6,739,553,2933,249,29,233,13,3,10,14,5,48.1665413533835,0.0383133384863956,0.0500797148707378,0.0474916816666606
146,1,90000,1606,962,752,476,1130,43,919,13,739,532,2788,239,28,210,22,7,10,9,9,51.843984962406,0.0153544664863741,0.0328851157925768,0.0476882893438546
147,1,90000,1534,989,754,427,1107,32,957,14,740,473,2804,213,28,192,17,4,10,8,10,47.2526315789474,-0.0424825471478915,9.93412838175001e-05,0.0255369040252643
148,1,90000,1487,910,718,439,1048,31,879,12,706,482,2633,217,26,199,15,3,13,9,4,43.7924812030075,-0.100664037393376,-0.0330884755468746,0.00492065844595264
149,1,90000,1412,893,677,441,971,29,864,12,665,482,2500,217,25,197,11,9,12,5,8,45.8221804511278,-0.141962832126036,-0.0588989127667356,-0.002800672759808
150,1,90000,1296,829,592,384,912,20,809,12,580,416,2301,187,23,172,11,4,13,6,4,37.1593984962406,-0.220810624489971,-0.100277811953544,-0.0375631354681513
151,1,90000,1235,828,631,361,874,20,808,14,617,395,2299,178,23,167,8,3,7,6,10,28.0744360902256,-0.29893898057078,-0.140477475290517,-0.0731413632222626
152,1,90000,1117,798,610,332,785,26,772,11,599,369,2156,166,22,154,11,1,9,6,7,17.5665413533835,-0.377539116050948,-0.179715244225195,-0.111486468019235
153,1,90000,1081,770,597,308,773,18,752,9,588,335,2113,151,21,139,8,4,10,5,6,15.4582706766917,-0.420059552050411,-0.202102307821394,-0.127519100626531
154,1,90000,1072,723,611,325,747,26,697,9,602,360,2046,162,20,144,15,3,6,7,7,11.9199248120301,-0.458992255508562,-0.221420697344725,-0.145345977634322
155,1,90000,1017,786,654,315,702,23,763,12,642,350,2107,158,21,143,8,7,6,7,8,11.3477443609023,-0.4774074147323,-0.230359317845696,-0.153589110861703
156,1,90000,993,736,571,306,687,26,710,6,565,338,1962,152,20,135,14,3,4,10,6,6.42518796992481,-0.499827998265182,-0.23946199224325,-0.170253039668364
1,2,95000,1176,831,719,336,840,19,812,10,709,365,2361,164,24,151,8,5,7,12,5,6.48045112781955,-0.480342803330587,-0.226895109667657,-0.171387774253721
2,2,95000,1234,893,657,377,857,19,874,14,643,410,2374,184,24,168,10,6,8,11,5,5.33646616541353,-0.457465616493521,-0.213161479985628,-0.171345676755081
3,2,95000,1263,883,647,380,883,24,859,14,633,418,2375,188,24,170,12,6,9,9,6,1.64360902255639,-0.433060237991038,-0.198032261641117,-0.175221152576721
4,2,95000,1344,968,673,403,941,31,937,7,666,441,2544,198,25,182,10,6,10,10,5,8.12481203007519,-0.364066696752449,-0.163389680839,-0.15149115426656
5,2,95000,1397,940,658,365,1032,34,906,14,644,413,2582,186,26,165,13,8,11,10,5,4.10263157894737,-0.324752531030578,-0.141413687448797,-0.152230811473241
6,2,95000,1499,999,707,413,1086,38,961,10,697,461,2744,207,27,187,14,6,12,10,5,10.1199248120301,-0.245442361045558,-0.102587858262687,-0.126540524924286
7,2,95000,1650,1024,730,505,1145,23,1001,8,722,536,2868,241,29,229,8,4,12,8,9,18.9462406015038,-0.153879721944638,-0.0591196420139427,-0.0930047877039546
8,2,95000,1713,1046,699,516,1197,29,1017,12,687,557,2901,251,29,232,12,7,11,11,7,8.0411320754717,-0.131478420441954,-0.0461721088572488,-0.108506149944481
9,2,95000,1788,1073,725,534,1254,40,1033,5,720,579,3007,261,30,241,16,4,12,8,10,7.85827067669173,-0.0741269575935405,-0.0193355289724893,-0.0974362028061945
10,2,95000,1949,1132,725,568,1381,27,1105,12,713,607,3199,273,32,258,12,3,13,10,9,18.8507518796992,0.0174579989639795,0.0209477267391996,-0.0591542334277128
11,2,95000,2076,1156,786,613,1463,44,1112,8,778,665,3353,299,34,277,20,2,17,12,5,24.1338345864662,0.0821687853396189,0.0484355488049923,-0.0363045306879426
12,2,95000,2216,1185,761,694,1522,41,1144,10,751,745,3417,335,34,311,20,4,17,9,8,28.706015037594,0.135881154725879,0.0699638036336846,-0.0167415416974004
13,2,95000,2268,1118,796,709,1559,37,1081,11,785,757,3425,341,34,319,18,4,16,13,5,25.0221804511278,0.151038466134901,0.0738374590298947,-0.0195797520494748
14,2,95000,2396,1164,803,739,1657,40,1124,15,788,794,3569,357,36,333,17,7,14,13,9,30.4131578947368,0.187671471392127,0.0859748836434954,-0.00163345059642431
15,2,95000,2350,1240,840,691,1659,44,1196,16,824,751,3679,338,37,305,24,9,17,13,7,47.6575187969925,0.25542146815919,0.110763346313488,0.0440176633099953
16,2,95000,2470,1181,776,774,1696,33,1148,5,771,812,3615,365,36,349,15,1,13,16,7,45.1555555555556,0.244140475559308,0.10130081368763,0.038461587280371
17,2,95000,2422,1174,809,714,1708,34,1140,7,802,755,3650,340,36,323,14,3,15,10,11,45.3868421052632,0.233454073042172,0.0920473616784966,0.0380895214983732
18,2,95000,2363,1185,840,724,1639,30,1155,16,824,770,3618,346,36,330,11,5,19,6,11,51.9751879699248,0.237422642010662,0.0893740165672838,0.0522438282961684
19,2,95000,2383,1188,850,716,1667,36,1152,14,836,766,3655,345,37,325,13,7,20,10,7,63.1586466165414,0.25159679518469,0.0917083999837295,0.0768734766368026
20,2,95000,2305,1159,857,695,1610,43,1116,16,841,754,3567,339,36,310,19,10,17,12,7,57.4799196787149,0.202825996149261,0.0680036873880545,0.0587364999118144
21,2,95000,2267,1130,854,684,1583,23,1107,12,842,719,3532,324,35,305,12,7,17,12,6,62.6281954887218,0.190085337795467,0.0609313467944231,0.0674784649438717
22,2,95000,2246,1146,874,668,1578,47,1099,13,861,728,3538,328,35,293,29,6,17,8,10,67.7966165413534,0.177602155727874,0.0553480444843275,0.0764989864857269
23,2,95000,2149,1182,829,693,1456,32,1150,10,819,735,3425,331,34,318,10,3,9,14,11,63.0624060150376,0.132564333491691,0.0373013068030377,0.0613754664794903
24,2,95000,2085,1119,860,663,1422,38,1081,12,848,713,3351,321,34,301,14,6,13,14,7,62.5830827067669,0.106194391677067,0.0287678414917604,0.057829198714364
25,2,95000,2143,1131,887,641,1502,40,1091,10,877,691,3470,311,35,291,15,5,20,12,3,62.3285714285714,0.0857152038361886,0.0242074870012309,0.0560347962886817
26,2,95000,2014,1075,830,613,1401,40,1035,10,820,663,3256,298,33,273,20,5,15,11,7,67.5,0.0902406797170965,0.0316615447876121,0.0691511486768509
27,2,95000,2135,1158,901,584,1551,26,1132,15,886,625,3569,281,36,264,9,8,17,11,8,69.7206766917293,0.0908949482863478,0.0385254659229134,0.0762885900205207
28,2,95000,2030,1169,887,606,1424,32,1137,14,873,652,3434,293,34,270,19,4,16,9,9,71.55,0.0965904610702635,0.0483228128555467,0.0837897684841498
29,2,95000,2096,1198,917,620,1476,38,1160,8,909,666,3545,300,35,284,14,2,14,13,8,70.9537593984962,0.0996832351121792,0.0574304941269727,0.0864081012001773
30,2,95000,2113,1131,836,649,1464,34,1097,11,825,694,3386,312,34,289,18,5,5,19,10,70.168045112782,0.107034874713776,0.0684099368863603,0.0894767117085245
31,2,95000,2172,1172,877,615,1557,29,1143,15,862,659,3562,297,36,274,12,11,14,13,9,72.2263157894737,0.127922468290149,0.0848464534645842,0.100241196170811
32,2,95000,2258,1209,860,665,1593,38,1171,10,850,713,3614,321,36,296,19,6,10,17,9,74.7161654135338,0.152275365142446,0.102043761656887,0.112271698401175
33,2,95000,2202,1274,963,655,1547,40,1234,20,943,715,3724,322,37,292,20,10,17,13,7,76.5744360902256,0.174563866092158,0.117283155773224,0.122474739807178
34,2,95000,2308,1241,872,720,1588,38,1203,18,854,776,3645,349,36,324,17,8,19,8,9,73.5515037593985,0.17804145752043,0.123089676418286,0.119780471877388
35,2,95000,2200,1214,889,685,1515,33,1181,11,878,729,3574,328,36,311,13,4,14,14,8,67.9676691729323,0.16901391397769,0.121935590092754,0.109561133244395
36,2,95000,2243,1157,923,700,1543,32,1125,14,909,746,3577,336,36,319,14,3,14,16,6,63.8785714285714,0.160037271215473,0.119052508725647,0.101571396453071
37,2,95000,2234,1241,815,705,1529,24,1217,12,803,741,3549,333,35,319,8,6,16,9,10,61.496992481203,0.15050339762478,0.114119431565313,0.0960274510270936
38,2,95000,2158,1185,830,617,1541,33,1152,13,817,663,3510,298,35,280,11,7,15,15,5,62.0642857142857,0.143782975086623,0.108613282748086,0.0958064558046156
39,2,95000,2165,1244,911,654,1511,39,1205,11,900,704,3616,317,36,294,15,8,11,14,11,55.5759398496241,0.104336108186444,0.0874261189678943,0.0757763976890443
40,2,95000,2048,1181,862,616,1432,36,1145,10,852,662,3429,298,34,276,18,4,15,7,12,56.6639097744361,0.0833454598722529,0.0727011965322283,0.0725119754031822
41,2,95000,2000,1156,850,617,1383,31,1125,10,840,658,3348,296,33,281,11,4,10,16,7,49.9646616541353,0.0275204263602648,0.041880497784093,0.0477182528919765
42,2,95000,1843,1104,866,556,1287,33,1071,9,857,598,3215,269,32,250,12,7,9,14,9,49.2778195488722,-0.013861672532927,0.0164212123258671,0.0361240497817079
43,2,95000,1705,1111,795,503,1202,28,1083,12,783,543,3068,244,31,230,9,5,13,11,7,43.3552631578947,-0.0787373011442823,-0.0195579103055757,0.00994483056105516
44,2,95000,1709,1014,775,528,1181,31,983,13,762,572,2926,257,29,232,20,5,12,13,4,44.4067669172932,-0.122557675750492,-0.0465691457383104,0.000130836669410328
45,2,95000,1459,1018,747,428,1031,34,984,6,741,468,2756,211,28,193,15,3,14,8,6,28.8853383458647,-0.225634039041668,-0.0986397291389445,-0.0516907732839852
46,2,95000,1481,1030,728,438,1043,24,1006,6,722,468,2771,211,28,193,14,4,11,7,10,31.2541353383459,-0.26506540526894,-0.122730834332872,-0.0588239029774236
47,2,95000,1266,905,749,341,925,35,870,12,737,388,2532,175,25,150,18,7,9,11,5,15.2642857142857,-0.365389831497141,-0.171893693855068,-0.111336900667728
48,2,95000,1275,944,750,406,869,23,921,9,741,438,2531,197,25,175,15,7,4,14,7,16.1868421052632,-0.400900891760629,-0.191993882102507,-0.120511697823835
49,2,95000,1192,893,733,356,836,28,865,6,727,390,2428,176,24,159,14,3,7,15,2,11.1744360902256,-0.449507580393211,-0.216236314861189,-0.142968164714038
50,2,95000,1177,880,699,353,824,31,849,9,690,393,2363,177,24,158,14,5,7,9,8,8.9890977443609,-0.478802839249891,-0.23063242769153,-0.156370915300531
51,2,95000,1173,856,681,351,822,28,828,8,673,387,2323,174,23,160,11,3,6,11,6,6.42781954887218,-0.498673547200389,-0.239408809356805,-0.168388130906705
52,2,95000,1189,865,701,356,833,31,834,10,691,397,2358,179,24,162,12,5,9,10,5,5.06503759398496,-0.502779151160257,-0.239925851012466,-0.174853191115061
53,2,95000,1114,883,626,339,775,35,848,10,616,384,2239,173,22,155,13,5,7,9,6,-3.20413533834586,-0.519201050830736,-0.244378808815996,-0.195918523384973
54,2,95000,1161,942,642,332,829,29,913,12,630,373,2372,168,24,151,11,6,8,12,4,-4.30263157894737,-0.498949250110498,-0.232004425403326,-0.196407770757025
55,2,95000,1225,922,677,378,847,29,893,13,664,420,2404,189,24,170,15,4,7,7,10,-1.52406015037594,-0.454386833659465,-0.208391116250526,-0.184695869953394
56,2,95000,1270,925,702,369,901,30,895,8,694,407,2490,183,25,165,16,2,9,7,9,4.27669172932331,-0.389856947478884,-0.175729869135232,-0.16317728476021
57,2,95000,1360,1004,718,400,960,37,967,18,700,455,2627,205,26,182,15,8,10,10,6,8.05263157894737,-0.324822372914429,-0.142711221861423,-0.144828512160552
58,2,95000,1447,1001,738,452,995,37,964,15,723,504,2682,227,27,209,15,3,10,10,7,2.24398496240602,-0.287895174622372,-0.121945546163073,-0.148989756030231
59,2,95000,1594,964,661,478,1116,40,924,10,651,528,2691,238,27,212,20,6,11,8,8,7.52857142857143,-0.209098446032012,-0.083768726274379,-0.124464655714525
60,2,95000,1568,1048,696,466,1102,30,1018,7,689,503,2809,226,28,216,7,3,8,13,7,3.35037593984962,-0.162891422818092,-0.0603764124501685,-0.123171597937717
61,2,95000,1836,1115,701,530,1306,49,1066,6,695,585,3067,263,31,239,23,1,15,11,5,14.6725563909774,-0.0644031234212173,-0.0156216125295365,-0.0832325592301521
62,2,95000,1870,1028,703,559,1311,32,996,10,693,601,3000,270,30,248,17,5,11,8,11,11.4473684210526,-0.0211581638761946,0.00425898319774624,-0.0802698987943983
63,2,95000,1935,1185,737,581,1354,40,1145,11,726,632,3225,284,32,257,21,6,10,13,9,12.9695488721805,0.0322809051349889,0.02723588157102,-0.0664963525444209
64,2,95000,2051,1125,777,659,1392,29,1096,14,763,702,3251,316,33,297,13,6,11,13,9,20.5977443609023,0.098944051700547,0.0546183405717465,-0.0388882555576356
65,2,95000,2209,1217,752,697,1512,36,1181,7,745,740,3438,333,34,312,18,3,17,14,3,25.8639097744361,0.147920891062787,0.0732537348156142,-0.0188934781384163
66,2,95000,2269,1167,758,668,1601,42,1125,8,750,718,3476,323,35,304,16,3,16,10,9,28.6398496240602,0.178001963213569,0.0827965582419269,-0.00700217009799764
67,2,95000,2349,1211,811,695,1654,34,1177,9,802,738,3633,332,36,313,16,3,16,13,7,34.8736842105263,0.209785750288062,0.092315229661502,0.0116009435031792
68,2,95000,2375,1154,801,747,1628,24,1130,17,784,788,3542,355,35,339,9,7,15,9,11,34.2984962406015,0.207657845014576,0.086840060335501,0.0113080244612906
69,2,95000,2349,1172,823,735,1614,30,1142,17,806,782,3562,352,36,333,9,10,19,8,9,40.4736842105263,0.219904374012812,0.0873941317551019,0.0261847140422411
70,2,95000,2346,1232,828,704,1642,42,1190,15,813,761,3645,342,36,320,16,6,15,13,8,47.1097744360902,0.225789296439384,0.0854350965601265,0.0407691753611072
71,2,95000,2321,1223,830,668,1653,37,1186,15,815,720,3654,324,37,301,15,8,15,16,6,53.7281954887218,0.225279440108727,0.0812878599344371,0.054203141170761
72,2,95000,2267,1139,835,672,1595,33,1106,9,826,714,3527,321,35,305,13,3,14,12,9,49.9665413533835,0.184009116567657,0.0605372924486023,0.0409723892406703
73,2,95000,2301,1109,868,672,1629,29,1080,6,862,707,3571,318,36,299,14,5,18,11,7,61.0992481203008,0.192485161733066,0.0622396881840867,0.0646828095144771
74,2,95000,2230,1179,852,667,1563,37,1142,9,843,713,3548,321,35,295,21,5,9,11,15,66.8770676691729,0.181901110716571,0.0571121137107011,0.0751320411115415
75,2,95000,2230,1186,922,724,1506,33,1153,18,904,775,3563,349,36,326,15,8,20,7,9,66.1199248120301,0.15008878584478,0.044355606500437,0.0697647439116168
76,2,95000,2187,1186,866,607,1580,34,1152,15,851,656,3583,295,36,272,14,9,17,13,6,73.7360902255639,0.150969729996724,0.0471254730316501,0.0861954206568286
77,2,95000,2085,1144,866,609,1476,32,1112,5,861,646,3449,291,34,272,18,1,18,9,7,73.1015037593985,0.127781604248876,0.0410528406854354,0.0831348558791788
78,2,95000,2123,1139,853,666,1457,36,1103,14,839,716,3399,322,34,299,14,9,14,9,11,71.3887218045113,0.106648548504006,0.037204430267177,0.0786951447584057
79,2,95000,2160,1206,889,616,1544,28,1178,12,877,656,3599,295,36,282,7,6,16,7,13,78.9342105263158,0.124310678632372,0.0511155832130839,0.0987961397405023
80,2,95000,2088,1161,851,627,1461,39,1122,11,840,677,3423,305,34,283,17,5,16,10,8,72.3451127819549,0.0989698538107144,0.0474492690742945,0.0849268329392336
81,2,95000,2084,1155,862,607,1477,35,1120,14,848,656,3445,295,34,270,16,9,17,11,6,71.9466165413534,0.101357203993689,0.0561828218283034,0.0877648270015677
82,2,95000,2093,1174,916,614,1479,26,1148,17,899,657,3526,296,35,272,15,9,13,12,10,74.7236842105263,0.120060386362028,0.072052120751766,0.0995382413376656
83,2,95000,2260,1189,841,664,1596,38,1151,7,834,709,3581,319,36,298,18,3,18,13,5,74.587969924812,0.132516556985215,0.0849976063578373,0.104706687903808
84,2,95000,2212,1234,834,694,1518,31,1203,14,820,739,3541,333,35,311,18,4,19,7,9,72.0605263157895,0.13898464649705,0.0947453637798042,0.104187029840973
85,2,95000,2244,1177,907,668,1576,38,1139,16,891,722,3606,325,36,297,22,6,16,14,6,70.1992481203008,0.148393335500009,0.104763359309366,0.105195189500474
86,2,95000,2271,1217,863,670,1601,30,1187,12,851,712,3639,320,36,303,11,6,15,13,8,72.0759398496241,0.169625796718523,0.118546352861772,0.114964874133463
87,2,95000,2242,1306,944,721,1521,50,1256,17,927,788,3704,355,37,319,26,10,14,14,9,70.1428571428571,0.174423871231455,0.123735200145799,0.114191323562926
88,2,95000,2261,1240,877,685,1576,53,1187,18,859,756,3622,340,36,307,24,9,15,12,9,69.9116541353384,0.180384761968242,0.127700864545134,0.116255808719474
89,2,95000,2344,1280,912,719,1625,36,1244,6,906,761,3775,342,38,325,14,3,16,12,10,66.8759398496241,0.170302317578607,0.122986082807785,0.109557296985801
90,2,95000,2246,1208,942,664,1582,48,1160,11,931,723,3673,325,37,303,17,5,11,13,13,70.0962406015038,0.174812015153839,0.12272946113827,0.116496787677807
91,2,95000,2147,1321,874,631,1516,47,1274,17,857,695,3647,313,36,284,24,5,12,14,10,54.4342105263158,0.105287752276487,0.089049485581416,0.0740801224097095
92,2,95000,2081,1100,809,610,1471,39,1061,11,798,660,3330,297,33,278,16,3,12,13,8,51.2857142857143,0.0714594789635244,0.0691609044845597,0.0607622940294937
93,2,95000,2046,1173,845,613,1433,39,1134,12,833,664,3400,299,34,272,21,6,11,10,13,51.0481203007519,0.0400721543465562,0.0490754284889244,0.052620887840081
94,2,95000,1892,1145,854,592,1300,32,1113,10,844,634,3257,285,33,266,14,5,12,14,7,52.0718045112782,0.00620947027644758,0.0270116647613235,0.0457333089055447
95,2,95000,1755,1075,807,504,1251,33,1042,11,796,548,3089,247,31,228,15,4,12,10,9,37.340977443609,-0.0883595869753003,-0.0216171436738001,-0.00212938225589102
96,2,95000,1637,1084,776,483,1154,28,1056,15,761,526,2971,237,30,216,15,6,10,8,12,36.8800751879699,-0.136822591397133,-0.0506413764636263,-0.0155009988253975
97,2,95000,1601,1021,792,486,1115,37,984,16,776,539,2875,243,29,218,18,7,13,7,9,35.8428571428571,-0.189100424755843,-0.0810609118087754,-0.0310174781397493
98,2,95000,1483,971,790,476,1007,34,937,13,777,523,2721,235,27,211,18,6,10,8,9,33.6657894736842,-0.244918447290251,-0.112382907175698,-0.0495578031083817
99,2,95000,1385,955,741,415,970,18,937,9,732,442,2639,199,26,187,9,3,7,11,8,25.5466165413534,-0.318752852839341,-0.150476300789734,-0.0825749822048115
100,2,95000,1401,959,750,427,974,34,925,12,738,473,2637,213,26,196,12,5,11,7,8,30.4191729323308,-0.342046653911926,-0.165682357149812,-0.0821879233581078
101,2,95000,1168,960,722,347,821,34,926,12,710,393,2457,177,25,159,13,5,5,10,10,13.2315789473684,-0.435363030794457,-0.209466412235264,-0.135514722764687
102,2,95000,1289,873,666,402,887,20,853,10,656,432,2396,194,24,181,8,5,7,8,9,10.8842105263158,-0.467721431673592,-0.225572306560017,-0.149854773351653
103,2,95000,1136,836,673,358,778,31,805,17,656,406,2239,183,22,160,16,7,10,4,8,-0.17406015037594,-0.520114879678405,-0.248678266257015,-0.183721931046173
104,2,95000,1258,884,680,371,887,33,851,10,670,414,2408,186,24,173,10,3,11,9,4,6.75977443609023,-0.498123560809172,-0.238374675589769,-0.17009958170428
105,2,95000,1148,883,687,350,798,22,861,11,676,383,2335,172,23,153,14,5,6,8,9,1.50300751879699,-0.506961991857181,-0.239894001947286,-0.184303749348904
106,2,95000,1160,867,697,334,826,30,837,11,686,375,2349,169,23,150,12,7,9,8,6,4.17992277992278,-0.476333260682286,-0.223324652949313,-0.176008382469324
107,2,95000,1178,885,658,368,810,26,859,10,648,404,2317,182,23,170,9,3,7,10,6,-2.0109022556391,-0.46574147000596,-0.214445523948104,-0.18732731712926
108,2,95000,1183,858,650,365,818,34,824,11,639,410,2281,184,23,164,16,4,12,4,7,-4.19436090225564,-0.431351247094767,-0.194791551449935,-0.186302080519123
109,2,95000,1343,1000,640,397,946,28,972,17,623,442,2541,199,25,174,17,8,11,7,7,-1.0484962406015,-0.370230051912914,-0.163452301154652,-0.169963034524247
110,2,95000,1406,961,662,419,987,30,931,10,652,459,2570,207,26,190,11,6,9,12,5,2.72593984962406,-0.300904577057778,-0.128718142029149,-0.150484523289981
111,2,95000,1502,1049,713,469,1033,38,1011,14,699,521,2743,234,27,212,14,8,7,12,8,12.0545112781955,-0.208481476493809,-0.0845396074091118,-0.116038936872732
112,2,95000,1660,983,678,489,1171,27,956,8,670,524,2797,236,28,220,13,3,12,11,5,5.99924812030075,-0.16873955523964,-0.0636899314040038,-0.119494667484491
113,2,95000,1831,1106,764,545,1286,39,1067,9,755,593,3108,267,31,247,19,1,15,12,4,22.6936090225564,-0.0507273729179657,-0.0102893197567163,-0.0660502586898332
114,2,95000,1843,1092,704,544,1299,35,1057,12,692,591,3048,266,30,242,19,5,11,14,5,13.2339768339768,-0.0280125248416427,0.00110248547195953,-0.0784770575874576
115,2,95000,2047,1157,743,599,1448,19,1138,6,737,624,3323,281,33,270,8,3,15,12,6,20.8541353383459,0.0485526626521085,0.034311062663182,-0.0491558678580003
116,2,95000,2086,1191,827,673,1413,36,1155,17,810,726,3378,327,34,302,17,8,17,10,7,25.6233082706767,0.107384153531798,0.0586469152320032,-0.0283076801562743
117,2,95000,2156,1161,767,613,1543,34,1127,11,756,658,3426,296,34,278,16,2,13,13,8,28.8710526315789,0.151743354231042,0.0755818306426246,-0.0129116035566219
118,2,95000,2303,1196,787,674,1629,30,1166,18,769,722,3564,325,36,304,13,8,15,12,9,34.8748120300752,0.195708752607854,0.0913035523673018,0.00752841560597346
119,2,95000,2428,1212,859,693,1735,32,1180,11,848,736,3763,331,38,315,11,5,17,10,11,43.1200772200772,0.23712332109574,0.105112439195794,0.0316421705823632
120,2,95000,2431,1234,827,694,1737,32,1202,8,819,734,3758,330,38,316,10,4,24,7,7,44.9804511278195,0.245981313830555,0.104430785574008,0.03789488553926
121,2,95000,2336,1233,863,719,1617,28,1205,19,844,766,3666,345,37,326,12,7,21,13,3,45.4996240601504,0.240641300799285,0.0974485275818272,0.0390369952988153
122,2,95000,2348,1166,802,707,1641,39,1127,14,788,760,3556,342,36,322,13,7,17,10,9,43.8932330827068,0.219529912265891,0.0838339573488465,0.0333472939408884
123,2,95000,2407,1214,894,708,1699,48,1166,17,877,773,3742,348,37,317,23,8,15,8,14,51.9751879699248,0.225555544549135,0.0823188300647106,0.0506816189442638
124,2,95000,2275,1199,803,684,1591,36,1163,8,795,728,3549,328,35,305,18,5,17,12,6,55.5124060150376,0.210750498735729,0.0726669905115167,0.0558379608368557
125,2,95000,2226,1110,848,675,1551,29,1081,16,832,720,3464,324,35,298,20,6,16,13,6,56.0902255639098,0.182685360013453,0.0584036541689275,0.0531949706114979
126,2,95000,2253,1144,861,710,1543,33,1111,14,847,757,3501,341,35,325,10,6,19,10,6,59.4473684210526,0.163518376369671,0.0492476792973801,0.0575225258502303
127,2,95000,2265,1138,840,700,1565,36,1102,17,823,753,3490,339,35,327,11,1,18,13,4,65.1364661654135,0.153683064429101,0.0455349516252291,0.0681059805332208
128,2,95000,2123,1125,823,643,1480,27,1098,14,809,684,3387,308,34,288,12,8,13,8,13,64.7462406015038,0.125547580870169,0.0354909471121359,0.0642759213001713
129,2,95000,2051,1115,885,609,1442,27,1088,11,874,647,3404,291,34,276,11,4,17,6,11,66.1951127819549,0.108336923310662,0.0316206686836005,0.0661193807725729
130,2,95000,2147,1140,839,639,1508,29,1111,15,824,683,3443,307,34,287,14,6,16,10,8,73.1890977443609,0.116149049571364,0.0398581769801373,0.0831059949327446
131,2,95000,2087,1191,887,640,1447,41,1150,15,872,696,3469,313,35,284,22,7,18,8,9,69.8081081081081,0.0939443199901961,0.0364240649307934,0.0755405083592197
132,2,95000,2113,1177,859,621,1492,36,1141,11,848,668,3481,301,35,276,20,5,15,10,10,74.3928571428571,0.106114502130802,0.0486504330400319,0.0892728881111784
133,2,95000,2066,1169,827,617,1449,36,1133,4,823,657,3405,296,34,273,20,3,15,13,6,72.6210526315789,0.102243723097466,0.054606705979947,0.088388201707456
134,2,95000,2150,1178,908,636,1514,44,1134,11,897,691,3545,311,35,286,19,6,17,12,6,75.9139097744361,0.121555214971358,0.0707371517113703,0.10122887501117
135,2,95000,2202,1135,935,642,1560,20,1115,10,925,672,3600,302,36,290,8,4,12,9,15,76.3864661654135,0.135289558703969,0.0843287012472442,0.107782698102081
136,2,95000,2106,1192,890,594,1512,37,1155,17,873,648,3540,292,35,268,15,9,18,9,8,74.1616541353384,0.142381139829297,0.0945365243195326,0.107985762658338
137,2,95000,2246,1259,881,618,1628,37,1222,13,868,668,3718,301,37,278,16,7,19,9,9,76.5913533834587,0.166829503209969,0.111279009612295,0.119797358811742
138,2,95000,2254,1267,914,648,1606,49,1218,13,901,710,3725,320,37,294,20,6,19,10,8,71.8639097744361,0.165438018071676,0.115717668725104,0.11324425155583
139,2,95000,2290,1269,861,704,1586,40,1229,11,850,755,3665,340,37,309,24,7,21,9,7,68.6078947368421,0.166547413904644,0.119732606349226,0.109457287622695
140,2,95000,2252,1245,850,650,1602,47,1198,11,839,708,3639,319,36,297,17,5,21,6,9,71.9571428571429,0.186384693667725,0.130087016709206,0.120861336837477
141,2,95000,2250,1254,792,683,1567,32,1222,13,779,728,3568,328,36,305,15,8,20,10,6,63.2962406015038,0.158287342198731,0.118105529071832,0.100564897372325
142,2,95000,2224,1185,915,637,1587,42,1143,16,899,695,3629,313,36,287,21,5,18,9,9,62.503007518797,0.150653891700526,0.113087665307321,0.0979891951256875
143,2,95000,2103,1242,834,648,1455,30,1212,10,824,688,3491,310,35,291,16,3,13,12,10,54.087969924812,0.108514762334367,0.0915534535882425,0.0742354219796413
144,2,95000,2120,1160,858,649,1471,43,1117,15,843,707,3431,318,34,295,21,2,13,13,8,58.3789473684211,0.102736821145172,0.0840411873905038,0.08005930490172
145,2,95000,1982,1168,835,583,1399,32,1136,11,824,626,3359,282,34,259,19,4,12,15,7,48.1665413533835,0.0383133384863956,0.0500797148707378,0.0474916816666606
146,2,95000,1992,1163,773,578,1414,24,1139,6,767,608,3320,274,33,260,10,4,10,14,9,51.843984962406,0.0153544664863741,0.0328851157925768,0.0476882893438546
147,2,95000,1796,1125,837,550,1246,34,1091,9,828,593,3165,267,32,247,15,5,13,13,6,47.2526315789474,-0.0424825471478915,9.93412838175001e-05,0.0255369040252643
148,2,95000,1725,1033,777,521,1204,33,1000,10,767,564,2971,254,30,237,14,3,12,10,8,43.7924812030075,-0.100664037393376,-0.0330884755468746,0.00492065844595264
149,2,95000,1651,979,816,513,1138,31,948,12,804,556,2890,250,29,228,18,4,8,12,9,45.8221804511278,-0.141962832126036,-0.0588989127667356,-0.002800672759808
150,2,95000,1550,951,783,463,1087,26,925,18,765,507,2777,228,28,210,10,8,9,7,12,37.1593984962406,-0.220810624489971,-0.100277811953544,-0.0375631354681513
151,2,95000,1386,955,751,419,967,25,930,10,741,454,2638,204,26,190,11,3,9,9,8,28.0744360902256,-0.29893898057078,-0.140477475290517,-0.0731413632222626
152,2,95000,1275,943,781,364,911,43,900,15,766,422,2577,190,26,167,16,7,7,7,12,17.5665413533835,-0.377539116050948,-0.179715244225195,-0.111486468019235
153,2,95000,1263,907,686,353,910,29,878,15,671,397,2459,179,25,156,16,7,11,10,4,15.4582706766917,-0.420059552050411,-0.202102307821394,-0.127519100626531
154,2,95000,1215,921,702,357,858,27,894,8,694,392,2446,176,24,164,10,2,8,5,11,11.9199248120301,-0.458992255508562,-0.221420697344725,-0.145345977634322
155,2,95000,1178,887,673,336,842,27,860,3,670,366,2372,165,24,153,12,0,7,9,8,11.3477443609023,-0.4774074147323,-0.230359317845696,-0.153589110861703
156,2,95000,1130,839,683,336,794,29,810,9,674,374,2278,168,23,147,16,5,9,8,6,6.42518796992481,-0.499827998265182,-0.23946199224325,-0.170253039668364
1,3,2345000,716,555,438,112,604,12,543,1,437,125,1584,56,16,52,4,0,6,4,6,6.48045112781955,-0.480342803330587,-0.226895109667657,-0.171387774253721
2,3,2345000,730,535,434,111,619,11,524,0,434,122,1577,55,16,47,8,0,8,4,4,5.33646616541353,-0.457465616493521,-0.213161479985628,-0.171345676755081
3,3,2345000,733,519,398,122,611,6,513,0,398,128,1522,58,15,52,6,0,9,4,2,1.64360902255639,-0.433060237991038,-0.198032261641117,-0.175221152576721
4,3,2345000,816,594,385,134,682,5,589,1,384,140,1655,63,17,62,1,0,6,6,5,8.12481203007519,-0.364066696752449,-0.163389680839,-0.15149115426656
5,3,2345000,831,569,389,103,728,4,565,2,387,109,1680,49,17,46,2,1,4,3,10,4.10263157894737,-0.324752531030578,-0.141413687448797,-0.152230811473241
6,3,2345000,879,605,416,122,757,11,594,5,411,138,1762,62,18,53,7,2,12,5,1,10.1199248120301,-0.245442361045558,-0.102587858262687,-0.126540524924286
7,3,2345000,1039,680,448,169,870,9,671,2,446,180,1987,81,20,76,4,1,5,8,7,18.9462406015038,-0.153879721944638,-0.0591196420139427,-0.0930047877039546
8,3,2345000,1067,642,455,152,915,10,632,7,448,169,1995,76,20,71,2,3,12,4,4,8.0411320754717,-0.131478420441954,-0.0461721088572488,-0.108506149944481
9,3,2345000,1110,702,426,169,941,10,692,2,424,181,2057,81,21,73,6,2,8,7,6,7.85827067669173,-0.0741269575935405,-0.0193355289724893,-0.0974362028061945
10,3,2345000,1197,691,474,187,1010,8,683,3,471,198,2164,89,22,83,5,1,8,9,5,18.8507518796992,0.0174579989639795,0.0209477267391996,-0.0591542334277128
11,3,2345000,1284,720,435,185,1099,6,714,5,430,196,2243,88,22,83,3,2,8,7,7,24.1338345864662,0.0821687853396189,0.0484355488049923,-0.0363045306879426
12,3,2345000,1333,742,475,188,1145,11,731,5,470,204,2346,92,23,79,10,3,14,4,5,28.706015037594,0.135881154725879,0.0699638036336846,-0.0167415416974004
13,3,2345000,1373,722,484,197,1176,15,707,6,478,218,2361,98,24,90,6,2,14,6,4,25.0221804511278,0.151038466134901,0.0738374590298947,-0.0195797520494748
14,3,2345000,1409,766,491,219,1190,10,756,3,488,232,2434,104,24,100,3,1,13,8,3,30.4131578947368,0.187671471392127,0.0859748836434954,-0.00163345059642431
15,3,2345000,1446,746,534,222,1224,7,739,7,527,236,2490,106,25,102,1,3,12,6,7,47.6575187969925,0.25542146815919,0.110763346313488,0.0440176633099953
16,3,2345000,1381,728,494,217,1164,12,716,4,490,233,2370,105,24,94,9,2,7,6,11,45.1555555555556,0.244140475559308,0.10130081368763,0.038461587280371
17,3,2345000,1486,777,516,191,1295,9,768,1,515,201,2578,90,26,85,4,1,16,7,3,45.3868421052632,0.233454073042172,0.0920473616784966,0.0380895214983732
18,3,2345000,1469,744,523,219,1250,13,731,4,519,236,2500,106,25,98,4,4,12,9,4,51.9751879699248,0.237422642010662,0.0893740165672838,0.0522438282961684
19,3,2345000,1415,765,509,219,1196,9,756,4,505,232,2457,104,25,100,3,1,14,5,6,63.1586466165414,0.25159679518469,0.0917083999837295,0.0768734766368026
20,3,2345000,1453,746,476,220,1233,14,732,7,469,241,2434,108,24,98,8,2,12,7,5,57.4799196787149,0.202825996149261,0.0680036873880545,0.0587364999118144
21,3,2345000,1360,737,554,225,1135,17,720,4,550,246,2405,111,24,103,7,1,11,8,5,62.6281954887218,0.190085337795467,0.0609313467944231,0.0674784649438717
22,3,2345000,1415,714,505,211,1204,14,700,3,502,228,2406,103,24,97,6,0,11,6,7,67.7966165413534,0.177602155727874,0.0553480444843275,0.0764989864857269
23,3,2345000,1334,700,526,212,1122,11,689,1,525,224,2336,101,23,95,5,1,11,9,3,63.0624060150376,0.132564333491691,0.0373013068030377,0.0613754664794903
24,3,2345000,1321,666,545,194,1127,12,654,4,541,210,2322,94,23,87,5,2,12,4,7,62.5830827067669,0.106194391677067,0.0287678414917604,0.057829198714364
25,3,2345000,1245,690,525,174,1071,10,680,1,524,185,2275,83,23,79,3,1,8,6,9,62.3285714285714,0.0857152038361886,0.0242074870012309,0.0560347962886817
26,3,2345000,1320,692,537,202,1118,9,683,1,536,212,2337,95,23,90,4,1,12,6,5,67.5,0.0902406797170965,0.0316615447876121,0.0691511486768509
27,3,2345000,1287,697,491,216,1071,12,685,2,489,230,2245,104,22,97,5,2,13,5,4,69.7206766917293,0.0908949482863478,0.0385254659229134,0.0762885900205207
28,3,2345000,1282,704,507,184,1098,13,691,3,504,200,2293,90,23,84,6,0,11,7,5,71.55,0.0965904610702635,0.0483228128555467,0.0837897684841498
29,3,2345000,1268,731,538,189,1079,11,720,4,534,204,2333,92,23,83,6,3,11,5,7,70.9537593984962,0.0996832351121792,0.0574304941269727,0.0864081012001773
30,3,2345000,1297,761,584,210,1087,11,750,4,580,225,2417,101,24,96,2,3,9,10,5,70.168045112782,0.107034874713776,0.0684099368863603,0.0894767117085245
31,3,2345000,1333,688,531,182,1151,11,677,6,525,199,2353,90,24,84,5,1,9,8,7,72.2263157894737,0.127922468290149,0.0848464534645842,0.100241196170811
32,3,2345000,1373,793,578,204,1169,12,781,0,578,216,2528,97,25,92,5,0,10,10,5,74.7161654135338,0.152275365142446,0.102043761656887,0.112271698401175
33,3,2345000,1446,753,561,208,1238,11,742,8,553,227,2533,102,25,94,4,4,13,7,5,76.5744360902256,0.174563866092158,0.117283155773224,0.122474739807178
34,3,2345000,1408,729,560,208,1200,9,720,4,556,221,2476,99,25,96,2,1,16,6,3,73.5515037593985,0.17804145752043,0.123089676418286,0.119780471877388
35,3,2345000,1391,778,569,191,1200,13,765,6,563,210,2528,94,25,84,7,3,7,8,10,67.9676691729323,0.16901391397769,0.121935590092754,0.109561133244395
36,3,2345000,1363,735,566,208,1155,10,725,4,562,222,2442,100,24,96,2,2,11,7,6,63.8785714285714,0.160037271215473,0.119052508725647,0.101571396453071
37,3,2345000,1298,784,530,172,1126,8,776,6,524,186,2426,84,24,79,3,2,13,6,5,61.496992481203,0.15050339762478,0.114119431565313,0.0960274510270936
38,3,2345000,1397,685,568,207,1190,12,673,2,566,221,2429,99,24,92,7,0,13,6,5,62.0642857142857,0.143782975086623,0.108613282748086,0.0958064558046156
39,3,2345000,1372,743,500,202,1170,12,731,4,496,218,2397,98,24,92,4,2,12,10,2,55.5759398496241,0.104336108186444,0.0874261189678943,0.0757763976890443
40,3,2345000,1224,767,537,180,1044,13,754,5,532,198,2330,89,23,81,5,3,11,7,5,56.6639097744361,0.0833454598722529,0.0727011965322283,0.0725119754031822
41,3,2345000,1185,716,507,153,1032,11,705,9,498,173,2235,78,22,68,5,5,11,8,3,49.9646616541353,0.0275204263602648,0.041880497784093,0.0477182528919765
42,3,2345000,1164,657,535,175,989,16,641,2,533,193,2163,87,22,79,8,0,8,8,6,49.2778195488722,-0.013861672532927,0.0164212123258671,0.0361240497817079
43,3,2345000,1060,621,479,138,922,7,614,3,476,148,2012,67,20,62,2,3,7,5,8,43.3552631578947,-0.0787373011442823,-0.0195579103055757,0.00994483056105516
44,3,2345000,999,639,488,153,846,9,630,2,486,164,1962,74,20,69,4,1,10,8,2,44.4067669172932,-0.122557675750492,-0.0465691457383104,0.000130836669410328
45,3,2345000,910,615,459,149,761,9,606,4,455,162,1822,73,18,67,5,1,7,6,5,28.8853383458647,-0.225634039041668,-0.0986397291389445,-0.0516907732839852
46,3,2345000,864,614,502,143,721,8,606,5,497,156,1824,70,18,63,4,3,3,7,8,31.2541353383459,-0.26506540526894,-0.122730834332872,-0.0588239029774236
47,3,2345000,825,574,448,122,703,6,568,3,445,131,1716,59,17,58,1,0,5,9,3,15.2642857142857,-0.365389831497141,-0.171893693855068,-0.111336900667728
48,3,2345000,803,573,439,144,659,9,564,6,433,159,1656,72,17,66,2,4,8,6,3,16.1868421052632,-0.400900891760629,-0.191993882102507,-0.120511697823835
49,3,2345000,739,552,401,108,631,7,545,3,398,118,1574,53,16,51,1,1,7,6,3,11.1744360902256,-0.449507580393211,-0.216236314861189,-0.142968164714038
50,3,2345000,714,489,408,106,608,4,485,1,407,111,1500,50,15,48,1,1,7,4,4,8.9890977443609,-0.478802839249891,-0.23063242769153,-0.156370915300531
51,3,2345000,764,562,397,110,654,8,554,5,392,123,1600,55,16,46,6,3,5,6,5,6.42781954887218,-0.498673547200389,-0.239408809356805,-0.168388130906705
52,3,2345000,728,531,413,108,620,1,530,3,410,112,1560,50,16,48,0,2,5,9,2,5.06503759398496,-0.502779151160257,-0.239925851012466,-0.174853191115061
53,3,2345000,703,506,428,93,610,5,501,4,424,102,1535,46,15,43,1,2,6,9,0,-3.20413533834586,-0.519201050830736,-0.244378808815996,-0.195918523384973
54,3,2345000,684,527,404,97,587,8,519,5,399,110,1505,50,15,43,3,4,5,5,5,-4.30263157894737,-0.498949250110498,-0.232004425403326,-0.196407770757025
55,3,2345000,763,525,428,112,651,7,518,8,420,127,1589,57,16,51,4,2,9,4,3,-1.52406015037594,-0.454386833659465,-0.208391116250526,-0.184695869953394
56,3,2345000,778,560,420,127,651,12,548,3,417,142,1616,64,16,58,6,0,4,7,5,4.27669172932331,-0.389856947478884,-0.175729869135232,-0.16317728476021
57,3,2345000,823,598,431,127,696,15,583,4,427,146,1706,66,17,60,5,1,7,7,3,8.05263157894737,-0.324822372914429,-0.142711221861423,-0.144828512160552
58,3,2345000,914,591,414,136,778,8,583,2,412,146,1773,66,18,61,5,0,10,4,4,2.24398496240602,-0.287895174622372,-0.121945546163073,-0.148989756030231
59,3,2345000,933,615,451,136,797,9,606,1,450,146,1853,66,19,58,7,1,7,9,3,7.52857142857143,-0.209098446032012,-0.083768726274379,-0.124464655714525
60,3,2345000,1021,593,426,148,873,7,586,1,425,156,1884,70,19,65,4,1,7,8,4,3.35037593984962,-0.162891422818092,-0.0603764124501685,-0.123171597937717
61,3,2345000,1075,702,434,155,920,12,690,5,429,172,2039,77,20,69,4,4,9,8,3,14.6725563909774,-0.0644031234212173,-0.0156216125295365,-0.0832325592301521
62,3,2345000,1200,707,432,188,1012,10,697,3,429,201,2138,90,21,83,4,3,9,9,3,11.4473684210526,-0.0211581638761946,0.00425898319774624,-0.0802698987943983
63,3,2345000,1190,755,440,174,1016,13,742,4,436,191,2194,86,22,79,5,2,9,9,4,12.9695488721805,0.0322809051349889,0.02723588157102,-0.0664963525444209
64,3,2345000,1290,711,488,179,1111,6,705,3,485,188,2301,85,23,80,2,3,13,8,2,20.5977443609023,0.098944051700547,0.0546183405717465,-0.0388882555576356
65,3,2345000,1346,721,474,209,1137,10,711,3,471,222,2319,100,23,93,4,3,10,7,6,25.8639097744361,0.147920891062787,0.0732537348156142,-0.0188934781384163
66,3,2345000,1360,744,455,214,1146,11,733,1,454,226,2333,102,23,94,7,1,12,6,5,28.6398496240602,0.178001963213569,0.0827965582419269,-0.00700217009799764
67,3,2345000,1441,757,479,205,1236,13,744,4,475,222,2455,100,25,92,6,2,10,9,6,34.8736842105263,0.209785750288062,0.092315229661502,0.0116009435031792
68,3,2345000,1485,705,493,225,1260,11,694,4,489,240,2443,108,24,101,6,1,13,3,8,34.2984962406015,0.207657845014576,0.086840060335501,0.0113080244612906
69,3,2345000,1370,721,528,181,1189,10,711,6,522,197,2422,89,24,87,1,1,9,8,7,40.4736842105263,0.219904374012812,0.0873941317551019,0.0261847140422411
70,3,2345000,1468,748,518,230,1238,12,736,9,509,251,2483,113,25,108,2,3,13,7,5,47.1097744360902,0.225789296439384,0.0854350965601265,0.0407691753611072
71,3,2345000,1464,738,512,214,1250,11,727,7,505,232,2482,104,25,98,4,2,18,4,3,53.7281954887218,0.225279440108727,0.0812878599344371,0.054203141170761
72,3,2345000,1370,710,524,216,1154,12,698,0,524,228,2376,103,24,95,8,0,15,6,3,49.9665413533835,0.184009116567657,0.0605372924486023,0.0409723892406703
73,3,2345000,1398,750,560,193,1205,17,733,5,555,215,2493,97,25,84,9,4,10,6,9,61.0992481203008,0.192485161733066,0.0622396881840867,0.0646828095144771
74,3,2345000,1385,767,516,228,1157,10,757,2,514,240,2428,108,24,102,5,1,12,6,6,66.8770676691729,0.181901110716571,0.0571121137107011,0.0751320411115415
75,3,2345000,1353,702,535,204,1149,8,694,4,531,216,2374,97,24,92,3,2,11,8,5,66.1199248120301,0.15008878584478,0.044355606500437,0.0697647439116168
76,3,2345000,1361,709,573,204,1157,10,699,1,572,215,2428,97,24,91,6,0,11,5,8,73.7360902255639,0.150969729996724,0.0471254730316501,0.0861954206568286
77,3,2345000,1312,725,525,178,1134,10,715,4,521,192,2370,86,24,80,6,0,8,8,8,73.1015037593985,0.127781604248876,0.0410528406854354,0.0831348558791788
78,3,2345000,1246,689,540,185,1061,6,683,5,535,196,2279,88,23,83,3,2,9,11,3,71.3887218045113,0.106648548504006,0.037204430267177,0.0786951447584057
79,3,2345000,1326,713,547,205,1121,12,701,1,546,218,2368,98,24,90,7,1,13,6,5,78.9342105263158,0.124310678632372,0.0511155832130839,0.0987961397405023
80,3,2345000,1363,668,551,203,1160,15,653,5,546,223,2359,100,24,90,7,3,8,9,7,72.3451127819549,0.0989698538107144,0.0474492690742945,0.0849268329392336
81,3,2345000,1325,713,499,196,1129,10,703,2,497,208,2329,94,23,93,1,0,7,8,8,71.9466165413534,0.101357203993689,0.0561828218283034,0.0877648270015677
82,3,2345000,1389,694,530,215,1174,7,687,7,523,229,2384,103,24,99,2,2,11,9,4,74.7236842105263,0.120060386362028,0.072052120751766,0.0995382413376656
83,3,2345000,1321,791,535,212,1109,12,779,7,528,231,2416,104,24,97,5,2,11,7,6,74.587969924812,0.132516556985215,0.0849976063578373,0.104706687903808
84,3,2345000,1325,751,538,201,1124,14,737,4,534,219,2395,99,24,92,5,2,7,9,8,72.0605263157895,0.13898464649705,0.0947453637798042,0.104187029840973
85,3,2345000,1359,750,512,201,1158,16,734,2,510,219,2402,99,24,93,6,0,12,3,9,70.1992481203008,0.148393335500009,0.104763359309366,0.105195189500474
86,3,2345000,1389,743,521,216,1173,11,732,3,518,230,2423,104,24,97,6,1,7,6,11,72.0759398496241,0.169625796718523,0.118546352861772,0.114964874133463
87,3,2345000,1365,722,540,225,1140,11,711,8,532,244,2383,110,24,101,6,3,9,8,7,70.1428571428571,0.174423871231455,0.123735200145799,0.114191323562926
88,3,2345000,1396,803,533,213,1183,12,791,3,530,228,2504,103,25,99,4,0,11,7,7,69.9116541353384,0.180384761968242,0.127700864545134,0.116255808719474
89,3,2345000,1433,768,526,193,1240,5,763,3,523,201,2526,90,25,86,3,1,12,6,7,66.8759398496241,0.170302317578607,0.122986082807785,0.109557296985801
90,3,2345000,1402,781,530,196,1206,15,766,8,522,219,2494,99,25,91,4,4,11,9,5,70.0962406015038,0.174812015153839,0.12272946113827,0.116496787677807
91,3,2345000,1281,728,518,182,1099,11,717,3,515,196,2331,88,23,84,3,1,8,5,10,54.4342105263158,0.105287752276487,0.089049485581416,0.0740801224097095
92,3,2345000,1212,751,507,186,1026,11,740,4,503,201,2269,90,23,83,6,1,11,7,5,51.2857142857143,0.0714594789635244,0.0691609044845597,0.0607622940294937
93,3,2345000,1271,697,552,188,1083,10,687,3,549,201,2319,90,23,86,3,1,14,3,6,51.0481203007519,0.0400721543465562,0.0490754284889244,0.052620887840081
94,3,2345000,1111,723,501,149,962,11,712,5,496,165,2170,74,22,69,4,1,10,6,6,52.0718045112782,0.00620947027644758,0.0270116647613235,0.0457333089055447
95,3,2345000,1040,671,474,147,893,13,658,3,471,163,2022,73,20,64,7,2,11,6,3,37.340977443609,-0.0883595869753003,-0.0216171436738001,-0.00212938225589102
96,3,2345000,1068,707,484,160,908,13,694,3,481,176,2083,79,21,70,7,2,7,7,7,36.8800751879699,-0.136822591397133,-0.0506413764636263,-0.0155009988253975
97,3,2345000,957,603,472,151,806,7,596,6,466,164,1868,74,19,68,2,4,10,2,7,35.8428571428571,-0.189100424755843,-0.0810609118087754,-0.0310174781397493
98,3,2345000,925,638,475,135,790,5,633,4,471,144,1894,65,19,60,1,4,5,11,3,33.6657894736842,-0.244918447290251,-0.112382907175698,-0.0495578031083817
99,3,2345000,855,585,469,108,747,11,574,3,466,122,1787,55,18,48,5,2,8,4,6,25.5466165413534,-0.318752852839341,-0.150476300789734,-0.0825749822048115
100,3,2345000,813,547,463,114,699,10,537,5,458,129,1694,58,17,51,4,3,5,6,6,30.4191729323308,-0.342046653911926,-0.165682357149812,-0.0821879233581078
101,3,2345000,705,556,425,102,603,12,544,2,423,116,1570,52,16,46,5,1,6,4,6,13.2315789473684,-0.435363030794457,-0.209466412235264,-0.135514722764687
102,3,2345000,730,561,451,108,622,15,546,10,441,133,1609,60,16,48,8,4,10,6,0,10.8842105263158,-0.467721431673592,-0.225572306560017,-0.149854773351653
103,3,2345000,724,539,405,102,622,7,532,1,404,110,1558,50,16,44,5,1,6,5,5,-0.17406015037594,-0.520114879678405,-0.248678266257015,-0.183721931046173
104,3,2345000,737,518,366,110,627,10,508,5,361,125,1496,56,15,47,5,4,6,6,3,6.75977443609023,-0.498123560809172,-0.238374675589769,-0.17009958170428
105,3,2345000,740,569,404,102,638,13,556,5,399,120,1593,54,16,44,8,2,7,4,5,1.50300751879699,-0.506961991857181,-0.239894001947286,-0.184303749348904
106,3,2345000,741,525,438,103,638,3,522,3,435,109,1595,49,16,46,1,2,8,3,5,4.17992277992278,-0.476333260682286,-0.223324652949313,-0.176008382469324
107,3,2345000,747,543,398,105,642,9,534,3,395,117,1571,53,16,49,3,1,8,4,4,-2.0109022556391,-0.46574147000596,-0.214445523948104,-0.18732731712926
108,3,2345000,769,573,394,122,647,6,567,3,391,131,1605,59,16,53,4,2,7,6,3,-4.19436090225564,-0.431351247094767,-0.194791551449935,-0.186302080519123
109,3,2345000,824,600,424,108,716,11,589,4,420,123,1725,55,17,46,6,3,5,8,4,-1.0484962406015,-0.370230051912914,-0.163452301154652,-0.169963034524247
110,3,2345000,814,585,411,117,697,8,577,4,407,129,1681,58,17,56,2,0,4,6,7,2.72593984962406,-0.300904577057778,-0.128718142029149,-0.150484523289981
111,3,2345000,988,622,421,154,834,10,612,3,418,167,1864,75,19,70,3,2,10,4,5,12.0545112781955,-0.208481476493809,-0.0845396074091118,-0.116038936872732
112,3,2345000,954,606,462,133,821,13,593,4,458,150,1872,68,19,58,7,3,6,9,4,5.99924812030075,-0.16873955523964,-0.0636899314040038,-0.119494667484491
113,3,2345000,1129,635,477,173,956,10,625,1,476,184,2057,83,21,80,2,1,9,9,3,22.6936090225564,-0.0507273729179657,-0.0102893197567163,-0.0660502586898332
114,3,2345000,1077,666,453,157,920,22,644,3,450,182,2014,82,20,74,8,0,7,9,4,13.2339768339768,-0.0280125248416427,0.00110248547195953,-0.0784770575874576
115,3,2345000,1181,736,491,196,985,9,727,5,486,210,2198,94,22,88,3,3,12,5,5,20.8541353383459,0.0485526626521085,0.034311062663182,-0.0491558678580003
116,3,2345000,1242,718,423,173,1069,8,710,4,419,185,2198,83,22,80,2,1,8,8,6,25.6233082706767,0.107384153531798,0.0586469152320032,-0.0283076801562743
117,3,2345000,1344,704,495,202,1142,12,692,3,492,217,2326,98,23,91,6,1,11,5,7,28.8710526315789,0.151743354231042,0.0755818306426246,-0.0129116035566219
118,3,2345000,1420,694,492,235,1185,12,682,3,489,250,2356,112,24,106,5,1,13,6,5,34.8748120300752,0.195708752607854,0.0913035523673018,0.00752841560597346
119,3,2345000,1513,768,484,219,1294,13,755,6,478,238,2527,107,25,98,5,4,11,8,6,43.1200772200772,0.23712332109574,0.105112439195794,0.0316421705823632
120,3,2345000,1534,733,507,236,1298,14,719,2,505,252,2522,113,25,106,6,1,14,8,3,44.9804511278195,0.245981313830555,0.104430785574008,0.03789488553926
121,3,2345000,1493,766,505,212,1281,8,758,2,503,222,2542,100,25,95,4,1,12,6,7,45.4996240601504,0.240641300799285,0.0974485275818272,0.0390369952988153
122,3,2345000,1470,777,513,194,1276,9,768,6,507,209,2551,94,26,88,3,3,13,8,5,43.8932330827068,0.219529912265891,0.0838339573488465,0.0333472939408884
123,3,2345000,1485,724,494,234,1251,12,712,4,490,250,2453,112,25,105,3,4,17,5,3,51.9751879699248,0.225555544549135,0.0823188300647106,0.0506816189442638
124,3,2345000,1492,735,514,237,1255,11,724,2,512,250,2491,112,25,104,6,2,13,6,6,55.5124060150376,0.210750498735729,0.0726669905115167,0.0558379608368557
125,3,2345000,1343,725,539,207,1136,10,715,0,539,217,2390,98,24,92,6,0,11,6,7,56.0902255639098,0.182685360013453,0.0584036541689275,0.0531949706114979
126,3,2345000,1381,737,529,207,1174,12,725,2,527,221,2426,99,24,94,4,1,12,5,7,59.4473684210526,0.163518376369671,0.0492476792973801,0.0575225258502303
127,3,2345000,1354,704,510,205,1149,5,699,5,505,215,2353,97,24,90,4,3,13,9,2,65.1364661654135,0.153683064429101,0.0455349516252291,0.0681059805332208
128,3,2345000,1344,684,539,231,1113,7,677,3,536,241,2326,108,23,102,4,2,12,5,6,64.7462406015038,0.125547580870169,0.0354909471121359,0.0642759213001713
129,3,2345000,1281,712,575,179,1102,7,705,5,570,191,2377,86,24,82,1,3,10,8,6,66.1951127819549,0.108336923310662,0.0316206686836005,0.0661193807725729
130,3,2345000,1339,712,555,182,1157,14,698,6,549,202,2404,91,24,83,6,2,9,4,11,73.1890977443609,0.116149049571364,0.0398581769801373,0.0831059949327446
131,3,2345000,1335,681,530,196,1139,8,673,3,527,207,2339,93,23,87,5,1,15,7,1,69.8081081081081,0.0939443199901961,0.0364240649307934,0.0755405083592197
132,3,2345000,1288,691,573,179,1109,15,676,3,570,197,2355,89,24,78,9,2,12,4,8,74.3928571428571,0.106114502130802,0.0486504330400319,0.0892728881111784
133,3,2345000,1308,703,527,201,1107,10,693,3,524,214,2324,96,23,90,4,2,11,7,5,72.6210526315789,0.102243723097466,0.054606705979947,0.088388201707456
134,3,2345000,1356,724,503,197,1159,12,712,4,499,213,2370,96,24,90,6,0,17,3,4,75.9139097744361,0.121555214971358,0.0707371517113703,0.10122887501117
135,3,2345000,1278,786,556,220,1058,8,778,1,555,229,2391,103,24,99,4,0,10,10,4,76.3864661654135,0.135289558703969,0.0843287012472442,0.107782698102081
136,3,2345000,1357,764,515,221,1136,11,753,2,513,234,2402,105,24,100,4,1,12,7,5,74.1616541353384,0.142381139829297,0.0945365243195326,0.107985762658338
137,3,2345000,1415,779,546,185,1230,12,767,4,542,201,2539,90,25,81,7,2,9,8,8,76.5913533834587,0.166829503209969,0.111279009612295,0.119797358811742
138,3,2345000,1376,799,590,204,1172,15,784,8,582,227,2538,102,25,91,9,2,12,8,5,71.8639097744361,0.165438018071676,0.115717668725104,0.11324425155583
139,3,2345000,1416,787,529,202,1214,8,779,1,528,211,2521,95,25,89,6,0,11,5,9,68.6078947368421,0.166547413904644,0.119732606349226,0.109457287622695
140,3,2345000,1419,792,538,225,1194,18,774,1,537,244,2505,110,25,103,7,0,7,14,4,71.9571428571429,0.186384693667725,0.130087016709206,0.120861336837477
141,3,2345000,1358,790,578,213,1145,15,775,7,571,235,2491,106,25,96,8,2,9,8,8,63.2962406015038,0.158287342198731,0.118105529071832,0.100564897372325
142,3,2345000,1355,769,514,203,1152,9,760,5,509,217,2421,98,24,91,4,3,9,9,6,62.503007518797,0.150653891700526,0.113087665307321,0.0979891951256875
143,3,2345000,1359,741,518,212,1147,10,731,4,514,226,2392,102,24,99,2,1,7,13,4,54.087969924812,0.108514762334367,0.0915534535882425,0.0742354219796413
144,3,2345000,1317,743,514,199,1118,10,733,2,512,211,2363,95,24,91,4,0,8,9,7,58.3789473684211,0.102736821145172,0.0840411873905038,0.08005930490172
145,3,2345000,1194,749,516,157,1037,13,736,2,514,172,2287,77,23,70,6,1,8,8,7,48.1665413533835,0.0383133384863956,0.0500797148707378,0.0474916816666606
146,3,2345000,1236,727,551,183,1053,15,712,7,544,205,2309,92,23,83,6,3,11,6,6,51.843984962406,0.0153544664863741,0.0328851157925768,0.0476882893438546
147,3,2345000,1170,697,495,188,982,6,691,4,491,198,2164,89,22,85,3,1,7,8,7,47.2526315789474,-0.0424825471478915,9.93412838175001e-05,0.0255369040252643
148,3,2345000,1078,667,486,155,923,11,656,1,485,167,2064,75,21,68,7,0,12,2,7,43.7924812030075,-0.100664037393376,-0.0330884755468746,0.00492065844595264
149,3,2345000,1041,638,508,152,889,10,628,3,505,165,2022,74,20,68,4,2,11,5,4,45.8221804511278,-0.141962832126036,-0.0588989127667356,-0.002800672759808
150,3,2345000,900,630,537,136,764,12,618,1,536,149,1918,67,19,61,6,0,9,2,8,37.1593984962406,-0.220810624489971,-0.100277811953544,-0.0375631354681513
151,3,2345000,852,576,501,139,713,9,567,9,492,157,1772,71,18,66,3,2,5,6,7,28.0744360902256,-0.29893898057078,-0.140477475290517,-0.0731413632222626
152,3,2345000,834,567,454,121,713,6,561,2,452,129,1726,58,17,56,2,0,3,11,3,17.5665413533835,-0.377539116050948,-0.179715244225195,-0.111486468019235
153,3,2345000,771,543,450,126,645,6,537,5,445,137,1627,62,16,55,3,4,8,5,3,15.4582706766917,-0.420059552050411,-0.202102307821394,-0.127519100626531
154,3,2345000,755,520,413,151,604,7,513,2,411,160,1528,72,15,67,3,2,7,7,1,11.9199248120301,-0.458992255508562,-0.221420697344725,-0.145345977634322
155,3,2345000,713,543,455,116,597,12,531,4,451,132,1579,59,16,54,4,1,7,6,3,11.3477443609023,-0.4774074147323,-0.230359317845696,-0.153589110861703
156,3,2345000,737,519,435,101,636,3,516,2,433,106,1585,48,16,46,0,2,7,4,5,6.42518796992481,-0.499827998265182,-0.23946199224325,-0.170253039668364
1,4,2470000,1184,831,654,190,994,11,820,9,645,210,2459,94,25,86,4,4,10,10,5,6.48045112781955,-0.480342803330587,-0.226895109667657,-0.171387774253721
2,4,2470000,1162,848,630,153,1009,12,836,4,626,169,2471,76,25,69,5,2,13,6,6,5.33646616541353,-0.457465616493521,-0.213161479985628,-0.171345676755081
3,4,2470000,1277,934,681,192,1085,12,922,7,674,211,2681,95,27,86,5,4,11,6,10,1.64360902255639,-0.433060237991038,-0.198032261641117,-0.175221152576721
4,4,2470000,1240,896,716,174,1066,14,882,2,714,190,2662,86,27,78,6,2,14,5,8,8.12481203007519,-0.364066696752449,-0.163389680839,-0.15149115426656
5,4,2470000,1328,900,632,189,1139,11,889,5,627,205,2655,92,27,83,5,4,12,10,5,4.10263157894737,-0.324752531030578,-0.141413687448797,-0.152230811473241
6,4,2470000,1491,999,678,245,1246,20,979,3,675,268,2900,121,29,108,12,1,12,9,8,10.1199248120301,-0.245442361045558,-0.102587858262687,-0.126540524924286
7,4,2470000,1640,1046,679,243,1397,15,1031,5,674,263,3102,118,31,104,9,5,15,11,5,18.9462406015038,-0.153879721944638,-0.0591196420139427,-0.0930047877039546
8,4,2470000,1660,977,666,234,1426,16,961,7,659,257,3046,116,30,112,3,1,14,8,8,8.0411320754717,-0.131478420441954,-0.0461721088572488,-0.108506149944481
9,4,2470000,1724,1067,771,248,1476,12,1055,3,768,263,3299,118,33,110,7,1,14,12,7,7.85827067669173,-0.0741269575935405,-0.0193355289724893,-0.0974362028061945
10,4,2470000,1878,1113,759,282,1596,14,1099,5,754,301,3449,135,34,130,4,1,15,13,6,18.8507518796992,0.0174579989639795,0.0209477267391996,-0.0591542334277128
11,4,2470000,2044,1081,800,342,1702,12,1069,5,795,359,3566,162,36,153,5,4,14,10,12,24.1338345864662,0.0821687853396189,0.0484355488049923,-0.0363045306879426
12,4,2470000,2121,1146,733,312,1809,16,1130,10,723,338,3662,152,37,143,6,3,18,11,8,28.706015037594,0.135881154725879,0.0699638036336846,-0.0167415416974004
13,4,2470000,2175,1156,743,322,1853,19,1137,3,740,344,3730,155,37,146,7,2,14,13,10,25.0221804511278,0.151038466134901,0.0738374590298947,-0.0195797520494748
14,4,2470000,2222,1188,790,333,1889,16,1172,5,785,354,3846,159,38,151,6,2,26,8,4,30.4131578947368,0.187671471392127,0.0859748836434954,-0.00163345059642431
15,4,2470000,2352,1159,815,352,2000,22,1137,10,805,384,3942,173,39,159,11,3,20,11,8,47.6575187969925,0.25542146815919,0.110763346313488,0.0440176633099953
16,4,2470000,2269,1208,781,350,1919,14,1194,2,779,366,3892,165,39,155,8,2,19,14,6,45.1555555555556,0.244140475559308,0.10130081368763,0.038461587280371
17,4,2470000,2376,1195,777,378,1998,14,1181,5,772,397,3951,179,40,168,9,2,22,12,6,45.3868421052632,0.233454073042172,0.0920473616784966,0.0380895214983732
18,4,2470000,2307,1165,812,326,1981,20,1145,6,806,352,3932,158,39,147,7,4,24,10,5,51.9751879699248,0.237422642010662,0.0893740165672838,0.0522438282961684
19,4,2470000,2392,1109,814,362,2030,17,1092,7,807,386,3929,174,39,165,5,4,19,10,10,63.1586466165414,0.25159679518469,0.0917083999837295,0.0768734766368026
20,4,2470000,2243,1082,839,366,1877,12,1070,8,831,386,3778,174,38,169,2,3,16,11,11,57.4799196787149,0.202825996149261,0.0680036873880545,0.0587364999118144
21,4,2470000,2211,1108,874,327,1884,25,1083,8,866,360,3833,162,38,150,8,4,18,12,8,62.6281954887218,0.190085337795467,0.0609313467944231,0.0674784649438717
22,4,2470000,2156,1153,843,294,1862,23,1130,10,833,327,3825,147,38,132,10,5,22,9,7,67.7966165413534,0.177602155727874,0.0553480444843275,0.0764989864857269
23,4,2470000,2097,1178,790,318,1779,16,1162,6,784,340,3725,153,37,145,6,2,18,13,6,63.0624060150376,0.132564333491691,0.0373013068030377,0.0613754664794903
24,4,2470000,2076,1148,778,311,1765,20,1128,7,771,338,3664,152,37,140,11,1,15,14,8,62.5830827067669,0.106194391677067,0.0287678414917604,0.057829198714364
25,4,2470000,2025,1174,889,291,1734,25,1149,6,883,322,3766,145,38,127,13,5,18,13,7,62.3285714285714,0.0857152038361886,0.0242074870012309,0.0560347962886817
26,4,2470000,2027,1069,815,306,1721,19,1050,3,812,328,3583,148,36,139,7,2,18,9,9,67.5,0.0902406797170965,0.0316615447876121,0.0691511486768509
27,4,2470000,2024,1101,807,309,1715,10,1091,3,804,322,3610,145,36,142,1,2,20,9,7,69.7206766917293,0.0908949482863478,0.0385254659229134,0.0762885900205207
28,4,2470000,1989,1144,875,302,1687,23,1121,5,870,330,3678,148,37,133,13,2,15,12,10,71.55,0.0965904610702635,0.0483228128555467,0.0837897684841498
29,4,2470000,2011,1100,840,305,1706,17,1083,7,833,329,3622,148,36,135,10,3,11,17,8,70.9537593984962,0.0996832351121792,0.0574304941269727,0.0864081012001773
30,4,2470000,2096,1128,892,317,1779,10,1118,4,888,331,3785,149,38,142,4,3,17,9,12,70.168045112782,0.107034874713776,0.0684099368863603,0.0894767117085245
31,4,2470000,2053,1209,872,303,1750,21,1188,3,869,327,3807,147,38,138,6,3,19,9,10,72.2263157894737,0.127922468290149,0.0848464534645842,0.100241196170811
32,4,2470000,2204,1216,848,319,1885,17,1199,3,845,339,3929,153,39,145,8,0,19,14,6,74.7161654135338,0.152275365142446,0.102043761656887,0.112271698401175
33,4,2470000,2228,1191,855,355,1873,14,1177,5,850,374,3900,168,39,159,6,3,14,20,5,76.5744360902256,0.174563866092158,0.117283155773224,0.122474739807178
34,4,2470000,2239,1159,835,321,1918,14,1145,8,827,343,3890,154,39,146,6,2,19,11,9,73.5515037593985,0.17804145752043,0.123089676418286,0.119780471877388
35,4,2470000,2184,1234,826,335,1849,21,1213,10,816,366,3878,165,39,156,7,2,18,11,10,67.9676691729323,0.16901391397769,0.121935590092754,0.109561133244395
36,4,2470000,2170,1136,872,334,1836,12,1124,7,865,353,3825,159,38,148,7,4,21,7,10,63.8785714285714,0.160037271215473,0.119052508725647,0.101571396453071
37,4,2470000,2080,1188,880,303,1777,17,1171,9,871,329,3819,148,38,138,5,5,14,14,10,61.496992481203,0.15050339762478,0.114119431565313,0.0960274510270936
38,4,2470000,2181,1179,844,300,1881,17,1162,4,840,321,3883,144,39,136,6,2,22,13,4,62.0642857142857,0.143782975086623,0.108613282748086,0.0958064558046156
39,4,2470000,2011,1127,858,281,1730,21,1106,9,849,311,3685,140,37,126,14,0,19,9,9,55.5759398496241,0.104336108186444,0.0874261189678943,0.0757763976890443
40,4,2470000,2065,1213,872,305,1760,15,1198,10,862,330,3820,148,38,134,8,6,22,10,6,56.6639097744361,0.0833454598722529,0.0727011965322283,0.0725119754031822
41,4,2470000,1889,1122,787,277,1612,15,1107,5,782,297,3501,134,35,123,8,3,19,7,9,49.9646616541353,0.0275204263602648,0.041880497784093,0.0477182528919765
42,4,2470000,1922,1122,808,289,1633,18,1104,4,804,311,3541,140,35,129,9,2,15,9,11,49.2778195488722,-0.013861672532927,0.0164212123258671,0.0361240497817079
43,4,2470000,1725,1061,761,248,1477,10,1051,7,754,265,3282,119,33,111,3,5,17,6,10,43.3552631578947,-0.0787373011442823,-0.0195579103055757,0.00994483056105516
44,4,2470000,1600,1073,770,239,1361,13,1060,9,761,261,3182,117,32,107,4,6,13,10,9,44.4067669172932,-0.122557675750492,-0.0465691457383104,0.000130836669410328
45,4,2470000,1502,1007,766,198,1304,6,1001,7,759,211,3064,95,31,93,1,1,16,8,7,28.8853383458647,-0.225634039041668,-0.0986397291389445,-0.0516907732839852
46,4,2470000,1429,918,696,250,1179,12,906,4,692,266,2777,120,28,112,6,2,13,8,7,31.2541353383459,-0.26506540526894,-0.122730834332872,-0.0588239029774236
47,4,2470000,1211,953,694,191,1020,10,943,5,689,206,2652,93,27,86,4,3,10,13,4,15.2642857142857,-0.365389831497141,-0.171893693855068,-0.111336900667728
48,4,2470000,1284,847,731,182,1102,16,831,7,724,205,2657,92,27,86,6,0,12,6,9,16.1868421052632,-0.400900891760629,-0.191993882102507,-0.120511697823835
49,4,2470000,1193,882,695,190,1003,12,870,5,690,207,2563,93,26,87,3,3,9,11,6,11.1744360902256,-0.449507580393211,-0.216236314861189,-0.142968164714038
50,4,2470000,1069,915,629,136,933,9,906,6,623,151,2462,68,25,62,3,3,6,12,7,8.9890977443609,-0.478802839249891,-0.23063242769153,-0.156370915300531
51,4,2470000,1152,827,661,173,979,14,813,4,657,191,2449,86,24,75,10,1,6,10,8,6.42781954887218,-0.498673547200389,-0.239408809356805,-0.168388130906705
52,4,2470000,1161,840,675,180,981,16,824,4,671,200,2476,90,25,81,7,2,12,9,4,5.06503759398496,-0.502779151160257,-0.239925851012466,-0.174853191115061
53,4,2470000,1116,846,696,160,956,12,834,9,687,181,2477,81,25,70,6,5,14,5,6,-3.20413533834586,-0.519201050830736,-0.244378808815996,-0.195918523384973
54,4,2470000,1143,860,623,177,966,11,849,5,618,193,2433,87,24,78,5,4,8,7,9,-4.30263157894737,-0.498949250110498,-0.232004425403326,-0.196407770757025
55,4,2470000,1158,906,630,178,980,15,891,5,625,198,2496,89,25,81,5,3,10,7,8,-1.52406015037594,-0.454386833659465,-0.208391116250526,-0.184695869953394
56,4,2470000,1266,884,665,192,1074,17,867,5,660,214,2601,96,26,89,5,2,10,7,9,4.27669172932331,-0.389856947478884,-0.175729869135232,-0.16317728476021
57,4,2470000,1295,933,676,235,1060,12,921,6,670,253,2651,114,27,109,3,2,10,8,9,8.05263157894737,-0.324822372914429,-0.142711221861423,-0.144828512160552
58,4,2470000,1465,957,657,256,1209,14,943,5,652,275,2804,124,28,117,6,1,12,10,6,2.24398496240602,-0.287895174622372,-0.121945546163073,-0.148989756030231
59,4,2470000,1526,955,698,233,1293,11,944,6,692,250,2929,112,29,105,3,4,16,9,4,7.52857142857143,-0.209098446032012,-0.083768726274379,-0.124464655714525
60,4,2470000,1617,1004,682,262,1355,17,987,4,678,283,3020,127,30,115,10,2,14,3,13,3.35037593984962,-0.162891422818092,-0.0603764124501685,-0.123171597937717
61,4,2470000,1759,1035,726,284,1475,21,1014,5,721,310,3210,140,32,131,9,0,14,8,10,14.6725563909774,-0.0644031234212173,-0.0156216125295365,-0.0832325592301521
62,4,2470000,1877,1029,724,283,1594,14,1015,1,723,298,3332,134,33,127,7,0,12,14,7,11.4473684210526,-0.0211581638761946,0.00425898319774624,-0.0802698987943983
63,4,2470000,1876,1155,771,288,1588,19,1136,7,764,314,3488,141,35,128,10,3,18,8,9,12.9695488721805,0.0322809051349889,0.02723588157102,-0.0664963525444209
64,4,2470000,1956,1128,772,299,1657,14,1114,3,769,316,3540,142,35,136,4,2,23,9,3,20.5977443609023,0.098944051700547,0.0546183405717465,-0.0388882555576356
65,4,2470000,2099,1190,792,322,1777,18,1172,7,785,347,3734,156,37,147,7,2,17,12,8,25.8639097744361,0.147920891062787,0.0732537348156142,-0.0188934781384163
66,4,2470000,2182,1153,794,328,1854,19,1134,7,787,354,3775,159,38,147,7,5,15,12,11,28.6398496240602,0.178001963213569,0.0827965582419269,-0.00700217009799764
67,4,2470000,2190,1160,785,315,1875,18,1142,6,779,339,3796,153,38,141,9,3,26,8,4,34.8736842105263,0.209785750288062,0.092315229661502,0.0116009435031792
68,4,2470000,2270,1177,830,346,1924,16,1161,7,823,369,3908,166,39,155,7,4,14,14,11,34.2984962406015,0.207657845014576,0.086840060335501,0.0113080244612906
69,4,2470000,2181,1176,780,329,1852,18,1158,8,772,355,3782,160,38,147,7,6,20,9,9,40.4736842105263,0.219904374012812,0.0873941317551019,0.0261847140422411
70,4,2470000,2288,1168,803,340,1948,14,1154,4,799,358,3901,161,39,158,3,0,19,12,8,47.1097744360902,0.225789296439384,0.0854350965601265,0.0407691753611072
71,4,2470000,2265,1220,858,327,1938,15,1205,14,844,356,3987,160,40,151,4,5,20,7,13,53.7281954887218,0.225279440108727,0.0812878599344371,0.054203141170761
72,4,2470000,2306,1097,799,351,1955,24,1073,9,790,384,3818,173,38,157,11,5,26,5,7,49.9665413533835,0.184009116567657,0.0605372924486023,0.0409723892406703
73,4,2470000,2324,1125,829,320,2004,22,1103,8,821,350,3928,158,39,141,11,6,19,10,10,61.0992481203008,0.192485161733066,0.0622396881840867,0.0646828095144771
74,4,2470000,2264,1104,829,321,1943,15,1089,3,826,339,3858,153,39,147,5,1,19,12,8,66.8770676691729,0.181901110716571,0.0571121137107011,0.0751320411115415
75,4,2470000,2073,1123,857,304,1769,15,1108,2,855,321,3732,144,37,135,8,1,14,12,11,66.1199248120301,0.15008878584478,0.044355606500437,0.0697647439116168
76,4,2470000,2160,1146,848,313,1847,13,1133,9,839,335,3819,151,38,141,5,5,19,8,11,73.7360902255639,0.150969729996724,0.0471254730316501,0.0861954206568286
77,4,2470000,2080,1131,872,330,1750,16,1115,7,865,353,3730,159,37,148,9,2,13,16,8,73.1015037593985,0.127781604248876,0.0410528406854354,0.0831348558791788
78,4,2470000,2073,1080,826,292,1781,11,1069,4,822,307,3672,138,37,130,6,2,18,9,10,71.3887218045113,0.106648548504006,0.037204430267177,0.0786951447584057
79,4,2470000,2236,1112,895,291,1945,15,1097,10,885,316,3927,142,39,130,6,6,21,7,11,78.9342105263158,0.124310678632372,0.0511155832130839,0.0987961397405023
80,4,2470000,2097,1118,811,308,1789,16,1102,5,806,329,3697,148,37,138,8,2,18,10,9,72.3451127819549,0.0989698538107144,0.0474492690742945,0.0849268329392336
81,4,2470000,2032,1113,862,309,1723,15,1098,4,858,328,3679,148,37,137,8,3,17,14,6,71.9466165413534,0.101357203993689,0.0561828218283034,0.0877648270015677
82,4,2470000,2064,1144,856,340,1724,9,1135,5,851,354,3710,159,37,155,3,1,18,13,6,74.7236842105263,0.120060386362028,0.072052120751766,0.0995382413376656
83,4,2470000,2107,1170,856,307,1800,18,1152,3,853,328,3805,148,38,140,7,1,23,7,8,74.587969924812,0.132516556985215,0.0849976063578373,0.104706687903808
84,4,2470000,2215,1194,860,355,1860,15,1179,7,853,377,3892,170,39,162,6,2,17,12,10,72.0605263157895,0.13898464649705,0.0947453637798042,0.104187029840973
85,4,2470000,2088,1126,866,323,1765,15,1111,6,860,344,3736,155,37,147,8,0,23,4,10,70.1992481203008,0.148393335500009,0.104763359309366,0.105195189500474
86,4,2470000,2207,1259,858,338,1869,12,1247,5,853,355,3969,160,40,150,6,4,18,15,7,72.0759398496241,0.169625796718523,0.118546352861772,0.114964874133463
87,4,2470000,2202,1200,901,334,1868,20,1180,6,895,360,3943,162,39,149,10,3,22,8,9,70.1428571428571,0.174423871231455,0.123735200145799,0.114191323562926
88,4,2470000,2223,1207,882,338,1885,20,1187,8,874,366,3946,165,39,151,11,3,14,14,11,69.9116541353384,0.180384761968242,0.127700864545134,0.116255808719474
89,4,2470000,2125,1229,897,296,1829,15,1214,7,890,318,3933,143,39,131,9,3,16,17,6,66.8759398496241,0.170302317578607,0.122986082807785,0.109557296985801
90,4,2470000,2210,1235,844,311,1899,16,1219,8,836,335,3954,151,40,140,8,3,16,11,13,70.0962406015038,0.174812015153839,0.12272946113827,0.116496787677807
91,4,2470000,2094,1225,823,312,1782,22,1203,9,814,343,3799,154,38,138,12,4,23,10,5,54.4342105263158,0.105287752276487,0.089049485581416,0.0740801224097095
92,4,2470000,2012,1161,816,295,1717,9,1152,7,809,311,3678,140,37,131,4,5,20,15,2,51.2857142857143,0.0714594789635244,0.0691609044845597,0.0607622940294937
93,4,2470000,1932,1097,800,309,1623,13,1084,2,798,324,3505,146,35,139,6,1,19,9,7,51.0481203007519,0.0400721543465562,0.0490754284889244,0.052620887840081
94,4,2470000,1821,1119,787,271,1550,17,1102,0,787,288,3439,130,34,125,5,0,16,12,6,52.0718045112782,0.00620947027644758,0.0270116647613235,0.0457333089055447
95,4,2470000,1674,1059,799,245,1429,14,1045,8,791,267,3265,120,33,112,7,1,12,12,9,37.340977443609,-0.0883595869753003,-0.0216171436738001,-0.00212938225589102
96,4,2470000,1610,1027,794,261,1349,14,1013,8,786,283,3148,127,31,115,10,2,17,9,5,36.8800751879699,-0.136822591397133,-0.0506413764636263,-0.0155009988253975
97,4,2470000,1516,1016,747,231,1285,15,1001,4,743,250,3029,112,30,98,11,3,15,8,7,35.8428571428571,-0.189100424755843,-0.0810609118087754,-0.0310174781397493
98,4,2470000,1424,1018,729,201,1223,18,1000,6,723,225,2946,101,29,90,9,2,13,11,5,33.6657894736842,-0.244918447290251,-0.112382907175698,-0.0495578031083817
99,4,2470000,1313,946,754,189,1124,12,934,10,744,211,2802,95,28,87,7,1,14,8,6,25.5466165413534,-0.318752852839341,-0.150476300789734,-0.0825749822048115
100,4,2470000,1277,936,685,177,1100,13,923,8,677,198,2700,89,27,75,8,6,11,6,10,30.4191729323308,-0.342046653911926,-0.165682357149812,-0.0821879233581078
101,4,2470000,1248,889,689,184,1064,14,875,3,686,201,2625,90,26,84,6,0,11,10,5,13.2315789473684,-0.435363030794457,-0.209466412235264,-0.135514722764687
102,4,2470000,1158,882,664,186,972,14,868,6,658,206,2498,93,25,85,6,2,11,9,5,10.8842105263158,-0.467721431673592,-0.225572306560017,-0.149854773351653
103,4,2470000,1116,835,611,159,957,15,820,7,604,181,2381,81,24,69,8,4,9,7,8,-0.17406015037594,-0.520114879678405,-0.248678266257015,-0.183721931046173
104,4,2470000,1131,821,650,180,951,9,812,7,643,196,2406,88,24,81,6,1,9,8,7,6.75977443609023,-0.498123560809172,-0.238374675589769,-0.17009958170428
105,4,2470000,1116,838,614,180,936,14,824,3,611,197,2371,89,24,82,6,1,15,6,3,1.50300751879699,-0.506961991857181,-0.239894001947286,-0.184303749348904
106,4,2470000,1147,861,676,183,964,9,852,5,671,197,2487,89,25,82,5,2,8,8,9,4.17992277992278,-0.476333260682286,-0.223324652949313,-0.176008382469324
107,4,2470000,1213,875,658,201,1012,15,860,7,651,223,2523,100,25,92,5,3,12,7,6,-2.0109022556391,-0.46574147000596,-0.214445523948104,-0.18732731712926
108,4,2470000,1249,845,656,177,1072,11,834,3,653,191,2559,86,26,79,5,2,12,6,8,-4.19436090225564,-0.431351247094767,-0.194791551449935,-0.186302080519123
109,4,2470000,1286,941,658,192,1094,13,928,1,657,206,2679,93,27,84,8,1,11,13,3,-1.0484962406015,-0.370230051912914,-0.163452301154652,-0.169963034524247
110,4,2470000,1446,880,664,229,1217,17,863,11,653,257,2733,116,27,104,7,5,12,8,7,2.72593984962406,-0.300904577057778,-0.128718142029149,-0.150484523289981
111,4,2470000,1526,1046,699,231,1295,11,1035,7,692,249,3022,112,30,105,6,1,10,13,7,12.0545112781955,-0.208481476493809,-0.0845396074091118,-0.116038936872732
112,4,2470000,1516,983,695,230,1286,17,966,2,693,249,2945,112,29,107,5,0,15,7,7,5.99924812030075,-0.16873955523964,-0.0636899314040038,-0.119494667484491
113,4,2470000,1677,1008,746,256,1421,17,991,7,739,280,3151,126,32,116,8,2,18,8,6,22.6936090225564,-0.0507273729179657,-0.0102893197567163,-0.0660502586898332
114,4,2470000,1823,1117,727,290,1533,15,1102,5,722,310,3357,140,34,128,8,4,14,12,8,13.2339768339768,-0.0280125248416427,0.00110248547195953,-0.0784770575874576
115,4,2470000,1883,1102,733,265,1618,10,1092,3,730,278,3440,125,34,122,3,0,19,11,4,20.8541353383459,0.0485526626521085,0.034311062663182,-0.0491558678580003
116,4,2470000,1986,1092,783,315,1671,17,1075,1,782,333,3528,150,35,143,6,1,18,9,8,25.6233082706767,0.107384153531798,0.0586469152320032,-0.0283076801562743
117,4,2470000,2100,1136,780,323,1777,20,1116,3,777,346,3670,156,37,148,7,1,18,11,8,28.8710526315789,0.151743354231042,0.0755818306426246,-0.0129116035566219
118,4,2470000,2242,1186,789,357,1885,10,1176,6,783,373,3844,168,38,159,7,2,16,13,9,34.8748120300752,0.195708752607854,0.0913035523673018,0.00752841560597346
119,4,2470000,2376,1236,809,349,2027,23,1213,10,799,382,4039,172,40,158,12,2,17,12,11,43.1200772200772,0.23712332109574,0.105112439195794,0.0316421705823632
120,4,2470000,2350,1204,823,384,1966,15,1189,12,811,411,3966,185,40,169,9,7,23,12,5,44.9804511278195,0.245981313830555,0.104430785574008,0.03789488553926
121,4,2470000,2373,1191,794,353,2020,18,1173,6,788,377,3981,170,40,160,8,2,22,10,8,45.4996240601504,0.240641300799285,0.0974485275818272,0.0390369952988153
122,4,2470000,2328,1141,768,327,2001,23,1118,7,761,357,3880,161,39,150,9,2,19,14,6,43.8932330827068,0.219529912265891,0.0838339573488465,0.0333472939408884
123,4,2470000,2307,1191,834,360,1947,11,1180,6,828,377,3955,170,40,159,7,4,22,11,7,51.9751879699248,0.225555544549135,0.0823188300647106,0.0506816189442638
124,4,2470000,2232,1159,852,358,1874,17,1142,10,842,385,3858,173,39,158,8,7,16,14,9,55.5124060150376,0.210750498735729,0.0726669905115167,0.0558379608368557
125,4,2470000,2284,1185,784,350,1934,10,1175,6,778,366,3887,165,39,156,6,3,19,10,10,56.0902255639098,0.182685360013453,0.0584036541689275,0.0531949706114979
126,4,2470000,2187,1169,820,306,1881,19,1150,7,813,332,3844,149,38,138,9,2,21,8,9,59.4473684210526,0.163518376369671,0.0492476792973801,0.0575225258502303
127,4,2470000,2193,1106,825,344,1849,23,1083,5,820,372,3752,167,38,154,12,1,22,4,12,65.1364661654135,0.153683064429101,0.0455349516252291,0.0681059805332208
128,4,2470000,2116,1132,819,332,1784,11,1121,2,817,345,3722,155,37,149,5,1,19,13,5,64.7462406015038,0.125547580870169,0.0354909471121359,0.0642759213001713
129,4,2470000,2075,1084,860,306,1769,16,1068,9,851,331,3688,149,37,135,10,4,19,11,7,66.1951127819549,0.108336923310662,0.0316206686836005,0.0661193807725729
130,4,2470000,2047,1122,817,320,1727,15,1107,5,812,340,3646,153,36,146,6,1,17,8,11,73.1890977443609,0.116149049571364,0.0398581769801373,0.0831059949327446
131,4,2470000,2051,1067,811,349,1702,16,1051,7,804,372,3557,167,36,159,5,3,17,12,7,69.8081081081081,0.0939443199901961,0.0364240649307934,0.0755405083592197
132,4,2470000,2053,1128,847,323,1730,24,1104,8,839,355,3673,160,37,145,14,1,20,7,10,74.3928571428571,0.106114502130802,0.0486504330400319,0.0892728881111784
133,4,2470000,2138,1130,870,307,1831,16,1114,4,866,327,3811,147,38,135,11,1,16,9,13,72.6210526315789,0.102243723097466,0.054606705979947,0.088388201707456
134,4,2470000,2064,1149,916,299,1765,19,1130,3,913,321,3808,144,38,133,9,2,14,9,15,75.9139097744361,0.121555214971358,0.0707371517113703,0.10122887501117
135,4,2470000,2145,1216,873,324,1821,18,1198,3,870,345,3889,155,39,148,7,0,22,12,5,76.3864661654135,0.135289558703969,0.0843287012472442,0.107782698102081
136,4,2470000,2262,1172,833,347,1915,19,1153,3,830,369,3898,166,39,156,10,0,17,13,9,74.1616541353384,0.142381139829297,0.0945365243195326,0.107985762658338
137,4,2470000,2119,1209,923,305,1814,23,1186,9,914,337,3914,152,39,138,11,3,22,10,7,76.5913533834587,0.166829503209969,0.111279009612295,0.119797358811742
138,4,2470000,2108,1153,877,312,1796,25,1128,9,868,346,3792,156,38,138,12,6,13,13,12,71.8639097744361,0.165438018071676,0.115717668725104,0.11324425155583
139,4,2470000,2257,1184,890,362,1895,19,1165,9,881,390,3941,176,39,165,9,2,20,11,8,68.6078947368421,0.166547413904644,0.119732606349226,0.109457287622695
140,4,2470000,2214,1195,934,311,1903,9,1186,6,928,326,4017,147,40,140,3,4,17,16,7,71.9571428571429,0.186384693667725,0.130087016709206,0.120861336837477
141,4,2470000,2192,1207,843,315,1877,23,1184,9,834,347,3895,156,39,142,10,4,15,14,10,63.2962406015038,0.158287342198731,0.118105529071832,0.100564897372325
142,4,2470000,2187,1283,843,321,1866,23,1260,9,834,353,3960,159,40,145,8,6,16,15,9,62.503007518797,0.150653891700526,0.113087665307321,0.0979891951256875
143,4,2470000,2081,1147,820,311,1770,16,1131,4,816,331,3717,149,37,141,6,2,19,9,9,54.087969924812,0.108514762334367,0.0915534535882425,0.0742354219796413
144,4,2470000,2052,1168,863,287,1765,14,1154,9,854,310,3773,140,38,129,8,3,22,9,7,58.3789473684211,0.102736821145172,0.0840411873905038,0.08005930490172
145,4,2470000,1955,1064,790,291,1664,13,1051,3,787,307,3502,138,35,134,1,3,16,9,10,48.1665413533835,0.0383133384863956,0.0500797148707378,0.0474916816666606
146,4,2470000,1811,1110,790,274,1537,13,1097,5,785,292,3419,131,34,123,5,3,20,8,6,51.843984962406,0.0153544664863741,0.0328851157925768,0.0476882893438546
147,4,2470000,1836,1087,743,268,1568,13,1074,2,741,283,3383,127,34,117,8,2,12,12,10,47.2526315789474,-0.0424825471478915,9.93412838175001e-05,0.0255369040252643
148,4,2470000,1735,1077,762,273,1462,15,1062,9,753,297,3277,134,33,127,5,2,16,7,10,43.7924812030075,-0.100664037393376,-0.0330884755468746,0.00492065844595264
149,4,2470000,1616,1014,825,266,1350,18,996,9,816,293,3162,132,32,119,9,4,16,10,6,45.8221804511278,-0.141962832126036,-0.0588989127667356,-0.002800672759808
150,4,2470000,1467,978,784,217,1250,16,962,1,783,234,2995,105,30,98,7,0,12,14,4,37.1593984962406,-0.220810624489971,-0.100277811953544,-0.0375631354681513
151,4,2470000,1368,926,770,238,1130,11,915,3,767,252,2812,113,28,108,5,0,12,8,8,28.0744360902256,-0.29893898057078,-0.140477475290517,-0.0731413632222626
152,4,2470000,1337,930,683,204,1133,8,922,8,675,220,2730,99,27,93,3,3,16,6,5,17.5665413533835,-0.377539116050948,-0.179715244225195,-0.111486468019235
153,4,2470000,1208,873,679,181,1027,7,866,4,675,192,2568,86,26,81,3,2,11,11,4,15.4582706766917,-0.420059552050411,-0.202102307821394,-0.127519100626531
154,4,2470000,1101,846,695,157,944,13,833,6,689,176,2466,79,25,70,6,3,11,8,6,11.9199248120301,-0.458992255508562,-0.221420697344725,-0.145345977634322
155,4,2470000,1172,853,668,167,1005,14,839,4,664,185,2508,83,25,73,7,3,13,5,7,11.3477443609023,-0.4774074147323,-0.230359317845696,-0.153589110861703
156,4,2470000,1146,870,660,174,972,17,853,3,657,194,2482,87,25,76,9,2,4,8,13,6.42518796992481,-0.499827998265182,-0.23946199224325,-0.170253039668364
